#Menu
User = Utilisateur
Join... = Rejoindre...
Login... = S'identifier...
Log in = Connexion
Logout = Déconnexion
Change password... = Changer le mot de passe...
User Preference = Préférences utilisateur
System Settings... = Paramètres système...
System Settings = Paramètres système
Crash = Crash
Invite friends... = Inviter des amis...
Language = Langue
Language Setting = Paramètres de la langue
English = Anglais
Polski (Polish) = Polski (Polonais)
Deutsch (German) = Deutsch (Allemand)
Français (French) = Français
简体中文 (Chinese - Simplified) = 简体中文 (Chinois simplifié)
正體中文 (Chinese - Traditional) = 正體中文 (Chinois traditionnel)
한국어 (Korean) = 한국어 (Coréen)
日本語 (Japanese) = 日本語 (Japonais)
Tiếng Việt (Vietnamese) = Tiếng Việt (Vietnamien)
Document Recovery = Récupération de document
Your Preferences Information = Information sur vos préférences
File = Fichiers
New = Nouveau
Project... = Projet...
Schematic = Schéma
Schematic-Simulation = Simulation-Schéma
Spice Symbol = Symbole Spice
Spice Subckt = Sous-circuit Spice
spicePre = spicePre
PCB = Circuit imprimé
Schematic Module = Module de schéma
PCB Module = Module de circuit imprimé
Save... = Enregistrer...
Save As... = Enregistrer sous...
Save As Module... = Enregistrer comme module...
Print = Imprimer
Export Document = Exporter le document
LTspice... = LTspice...
Eagle... = Eagle...
Altium... = Altium...
Cadence... = Cadence...
Pads... = Pastilles...
DXF = DXF
Import = Importer
Super Menu = Menu général

Edit = Éditer
Undo = Annuler
Redo = Rétablir
Cut = Couper
Copy = Copier
Paste = Coller
Select = Sélectionner
Delete = Supprimer
Clear All = Tout effacer
Move = Déplacer
Drag = Glisser
Bring to Front = Ammener à l'avant
Send to Back = Envoyer en arrière
Align = Aligner
Align Left = Aligner à gauche
Align Right = Aligner à droite
Align Top = Aligner en haut
Align Bottom = Aligner en bas
Align Horizontal Centers = Centrer horizontalement
Align Vertical Centers = Centrer verticalement
Distribute Horizontally = Répartir horizontalement
Distribute Vertically = Répartir verticalement
Distribute Left Edges Equidistantly = Répartir selon les bords de gauche
Distribute Top Edges Equidistantly = Répartir selon les bords du haut
Align Grid = Aligner sur la grille
Rotate = Rotation
Rotate Left = Rotation vers la gauche
Rotate Right = Rotation vers la droite
Flip Horizontal = Miroir horizontal
Flip Vertical = Miroir vertical
Rotate and Flip = Rotation et miroir
Group/Ungroup Symbol... = Grouper/Dégrouper les symboles...

[menu_project]
View = Vues
[/menu_project]
Find = Trouver
Zoom In = Zoom +
Zoom Out = Zoom -
Fit in Window = Ajuster à la fenêtre
Refresh = Actualiser
Snap = Accrocher
Cross Cursor = Pointeur en croix
Toolbars = Barres d'outils
Drawing Tools = Outils de dessin
Wiring Tools = Outils de câblage
Power Objects = Symboles d'alimentation
PCB Tools = Outils pour les circuits imprimés
Footprint Tools = Outils pour les empreintes
Layers Tool = Outils pour les calques
Layer Manager = Gestionnaire de calque
Enable and Show All Layers = Active et affiche tous les calques
Net Visible = Interconnexion visible
Auto = Auto
Digital Objects = Objets numériques
Tools = Outils
Arc Center = Centre d'arc
Arc Type = Type d'arc
Center Point Arc = Arc centré
Two-point Arc = Arc à 2 points

Place = Placer
Drawing Tools = Outils de dessin
Arc = Arc
Elliptical Arc = Arc elliptique
Ellipse = Ellipse
Circle = Cercle
Pie = Camembert
Line = Ligne
Polyline = Lignes multiples
Rectangle = Rectangle
Rectangular = Rectangulaire
The rectangle does not support non-90 degree rotation. Please use Solid Region instead. = Le rectangle ne supporte pas les rotations autre que de 90 degrés. Merci d'utiliser les régions pleines à la place.

Rect = Rect
Round Rectangle = Rectangle arrondi
Polygon = Polygone
Bezier = Bézier
Path = Chemin
Graphic = Grapique
Bus = Bus
Bus Entry = Entrée de bus
Junction = Jonction
Net Port = Port d'interconnexion
Voltage Probe = Sonde de tension
Power Port = Port d'alimentation
Wire = Connexion
Annotation = Annotation
Track = Piste
Image = Image
Arrow Head = Flèche d'entête
Arrowhead = Pointe de flèche
Arrow = Flèche
No Connect Flag = Drapeau de non connexion
Place = Placer
Pin = Broche
Lock Selected Objects = Verrouiller les objets sélectionnés

Miscellaneous = Divers
Find Component = Chercher un composant
Component = Composant
Footprint... = Empreinte...
This component is deleted! = Ce composant est supprimé !
Convert = Convertir
Convert Schematic to PCB = Convertir le schéma en circuit imprimé
The component ID will be reset according to the component prefix, this operation will clear Undo histories. Please notice: = L'identification du composant va être restaurée conformément à son préfixe, cette opération va vider l'historique des annulations. Veuillez noter :
Please make sure the component prefixes of the schematic and PCB are corresponding = Veuillez vérifier que les préfixes des composants dans le schéma et le circuit imprimé correspondent
Please reset the component ID of corresponding schematic or corresponding PCB too = Veuillez restaurer l'identification du composant dans le schéma ou circuit imprimé correspondant
Do you want to continue? = Voulez-vous continuer ?
Reset Component ID = Restaurer l'identification du composant
Component ID reset successfully! = Succès de la restauration de l'identification du composant
Convert to PCB = Convertir en circuit imprimé
Update PCB = Mettre à jour le circuit imprimé
Shortcut Keys Setting = Paramétrage des raccourcis clavier
Edit Symbol... = Édition de Symbole...
Highlight Net... = Interconnexion en surbrillance...
Simulate = Simuler
Simulation = Simulation
Standard Mode = Mode standard
Simulation Mode = Mode simulation
Change to Standard Mode = Passer en mode standard
Change to Simulation Mode = Passer en mode simulation
Welcome to Use LCEDA = Bienvenue sur LCEDA
Welcome to Use EasyEDA = Bienvenue sur EasyEDA
Enable Education Edition Features for Free >>> = Activer les fonctionalités de l'édition Éducation gratuitement >>>
Quick Start = Démarrage rapide
More Help = Plus d'aide
Explore = Explorer
Message = Message
[start]
Example = Exemple
Forum = Forum
Tutorials = Tutoriels
Videos = Vidéos
[/start]
Custom Data = Données personnalisées
LCEDA = LCEDA

Copy Result Image = Copier l'image résultante
Export Result Image = Exporter l'image résultante
Simulation Result = Résultat de simulation
Simulation Results... = Résultats de simulation...
Simulate this Sheet = Simuler cette feuille
Simulate this Project = Simuler ce projet
Non-simulation mode, please switch to the simulation mode first and then run = Vous n'êtes pas en mode simulation, veuillez d'abord basculer en mode simulation avant de démarrer
Run the Document = Démarrer le document
Run the Project... = Démarrer le projet...
Netlist for Document = Liste des interconnexions du document
Netlist for Project = Liste des interconnexions du projet
LTspice for This Sheet... = LTspice pour cette feuille...
Spice for this Project... = Spice pour ce projet...
Protel/Altium for PCB... = Protel/Altium pour circuit imprimé...
PADS for PCB... = PADS pour circuit imprimé...
FreePCB for PCB... = FreePCB pour circuit imprimé...
Eagle for PCB... = Eagle pour circuit imprimé...
Kicad for PCB... = Kicad pour circuit imprimé...
OrCAD for PCB... = OrCAD pour circuit imprimé...
BOM report... = Rapport de nommenclature...
BOM for Document... = Nommenclature du document...
BOM for Project... = Nommenclature du projet...
Pin Manager... = Gestionnaire de brochage...
Spice Model... = Modèle Spice...
Layer Manager... = Gestionnaire de calques...
Net Color... = Couleur des interconnexions...
Design Rule... = Règle de conception...
Copper Area = Zone de cuivre
Rebuild Selected = Reconstruire la sélection
Rebuild All = Tout reconstruire
Copper Area Manager... = Gestionnaire de zone de cuivre...
Export Pick and Place File = Exporter le fichier de placement des composants
Measure Distance = Mesurer une distance
Set Canvas Origin by Mouse Location = Définir l'origine du canevas d'après la position de la souris
Generates Pick and Place File = Générer le fichier de placement des composants
Unroute All = Supprimer tout le routage
Auto Route = Auto routage
Export Autorouter File(DSN) = Exporter un fichier d'auto routage (DSN)
Import Autorouter Session File(SES) = Importer un fichier de session d'auto routage (SES)
Autorouter File(DSN) = Fichier d'auto routage (DSN)
Autorouter Session File(SES) = Fichier de session d'auto routage (SES)
Terminate Routing Automatically = Arrêter le routage automatiquement
Delete Segments = Supprimer les segments
Unroute Connections = Ne plus router les connexions
Unroute Connection = Ne plus router la connexion
Unroute Nets = Ne plus routes toutes ces interconnexions
Select = Sélectionner
Segments = Segment
Connection = Connexion
Net = Interconnexion
Apply Design Rule While Routing and Auto Placing Via = Appliquer les règles de conception pendant le routage et le placement automatiques des vias

Add SubPart = Ajoute une sous-partie
Annotate... = Annoter...
Config = Configurer

Help = Aide
About = À Propos de
Shortcut Keys = Raccourcis clavier
FAQ = FAQ
Tutorials = Tutoriels
Basic Tutorials = Tutoriels basiques
Video Tutorials = Tutoriels en vidéo
Essential Check = Vérification essentielle
Simulation Tutorials = Tutoriels de simulation
Updated Instructions = Instructions mises à jour
Open File Format = Ouvrir le format de fichier
About Upgrade = À propos de la mise-à-jour
#Github Repository
Github Repository = Dépôt GitHub
#Support Forum
User Forum = Forum utilisateur
Feature Request = Demande d'amélioration
Feature Requests = Demandes d'amélioration
Bug Report = Rapport d'incident
Bug Reports = Rapports d'incident
Tips & Skill = Conseils et compétence
Ask for Help = Demander de l'aide
Schematic Capture = Capture de schéma
Spice Simulation = Simulation Spice
Non-simulation mode = Pas en mode simulation
PCB Layout = Disposition du circuit imprimé
General Discussion = Discussion générale
More Information = Plus d'informations
Privacy Policy = Politique de confidentialité
#Terms of Use & Privacy Policy
Terms of Service = Conditions d'utilisation
Plans and Pricing = Plans et tarifs
Help Translate = Aider à traduire
About Us = À propose de nous
Contact Us = Nous contacter
Change History = Modifier l'historique
Join Us = Rejoignez-nous
#PCB Fabrication Capabilities
PCB Fabrication = Fabrication de circuit imprimé
Order Capabilities = Possibilités de commande
Order Price = Prix de la commande
Order Essential Check = Vérifications essentielles de la commande
Order FAQ = Comment commander
Order Process = Processus pour passer commande
Full Screen = Plein écran

Support = Support
[leftNavTabs]
Support = Support
[/leftNavTabs]
Historical Records... = Enregistrements de l'historique...
Extensions = Extensions
Order PCB... = Commander des circuits imprimés...
Import Changes = Importer les changements
Press {0}F11{1} to switch to full screen. = Appuyez sur {0}F11{1} pour basculer en plein écran.
Delete Selected = Supprimer la sélection
Simulate... = Simuler...
Config = Configurer
Terms of Service & Privacy Policy = Conditions d'utilisation & Politique de confidentialité
Help Topics = Sujets de l'aide
3D Model(obj) = Modèles 3D (obj)
3D Model(step) = Modèles 3D (step)
SVG Source... = Source SVG...
File Source = Source du fichier
Group These Items as a Symbol = Grouper ces items en un symbole
Group These Items as a Footprint = Grouper ces items en une empreinte
Set Canvas Origin = Définir l'origine du canevas
Document Setting = Réglages du document
Sheet Attributes = Attributs de la feuille
Set Board Outline = Définir le contour de la plaque
Teardrop... = Larme...
Panelize... = Panéliser...
Check Dimension = Vérifier la dimension
Smart Dimension = Dimension intelligente
Footprint Wizard = Assistant d'empreinte
Footprint Wizard... = Assistant d'empreinte...
Select package type = Sélectionner le type de boîtier
Smart Dimension Attributes = Attributs de dimension intelligente
Global Delete = Suppression globale
Cross Probe = Sonde croisée
Cross Probe and Place = Sonde croisée et emplacement
Paper Size = Taille de la feuille
Register = S'inscrire
User Center = Centre utilisateur

By Mouse Location = Par positionnement de la souris
Set Coordinate = Définir les coordonnées
By Coordinates... = Par coordonnées...
By Center of Pads = Par le centre des contacts
By Center Grid of Symbols = Par le centre de la grille des symboles

#Schematic Canvas Attributes
Properties = Propriétés
Attributes = Attributs
Apply = Appliquer
Save as default = Enregistrer comme valeur par défaut
Canvas Attributes = Attibuts du canevas
Width = Largeur
Height = Hauteur
Background = Arrière-plan
Visible Grid = Grille visible
Grid Visible = Grille visible
Real-Time Track Length = Longueur temps-réelle de la piste
Display Real-Time Track Length = Afficher la longueur temps-réelle de la piste
Grid Color = Couleur de grille
Grid Size = Taille de grille
Grid Style = Style de grille
Grid.Line Width = Largeur Grid.Line
Grid.Line Spacing = Espacement Grid.Line
Copper to Board Outline = Cuivre sur le contour de la carte
Improve Fabrication = Améliorer la fabrication
Spoke Width = Largeur de rayon
Stroke Color = Couleur du trait
Stroke Width = Largeur du trait
Stroke Style = Style de trait
Fill Color = Couleur de remplissage
Selected Objects = Objets sélectionnés
Frame Size = Taille du cadre
Alt Snap = Accrochage Alternatif
Snap size when pressing the Alt key = Taille de l'accrochage en appuyant sur la touche Alt
Prefix Start = Début du préfixe

#Text Attributes
Text Attributes = Attributs du texte
Text = Texte
Color = Couleur
Font Family = Famille de la police
Font Size = Taille de la police
Font Weight = Graisse de la police
Font Style = Style de la police
Text Type = Type de texte
Text Anchor = Ancre de texte
Baseline = Ligne de base
(Auto) = (Auto)
(auto) = (auto)
start = début
middle = milieu
end = fin
inherit = hériter
comment = commenter
spice = spice
normal = normale
italic = italique
Default = Par défaut
Add = Ajouter
bold = gras
bolder = plus gras
lighter = moins gras
Failed to parse the font file: {name} = Échec de l'analyse du fichier de police : {name}
Please select a font file of ttf or woff format. = Veuillez choisir un fichier de police ou au format ttf ou woff.
Add font success: {name} = Ajout réussi de la police : {name}
Failed to add font: {name} = Échec de l'ajout de la police : {name}
Add Font = Ajouter la police
Failed to parse cached font: {name} = Échec de l'analyse de la police du cache : {name}
Load cached fonts fail! = Le chargement des polices du cache a échoué !

#Stroke
Stroke Color = Couleur du trait
Stroke Width = Largeur du trait
Stroke Style = Style du trait
Fill Color = Couleur de remplissage
X Radius = Rayon X
Y Radius = Rayon Y

#spice
Switch mode = Changer de mode
The current documents will be closed, and reopen after switching mode, do you want to continue? = Les documents actuels vont être fermés puis rouverts après avoir changé de mode, voulez-vous continuer ?
PCB related documents are not allowed in emulation mode = Les documents relatifs au circuit imprimé ne sont pas autorisés dans le mode émulation
Please change the editor to "Simulation" mode first at the top left corner. = Veuillez d'abord basculer l'éditeur dans le mode "Simulation" dans le coin supérieur gauche.
Please change the editor to "Standard" mode first at the top left corner. = Veuillez d'abord basculer l'éditeur dans le mode "Standard" dans le coin supérieur gauche.
Common = Commun
spice.open = spice.open
spice.close = spice.close
Sources = Sources
Instrument = Instrument
Transistors = Transistors
Digital Circuits = Circuits numériques
Operational Amplifier = Ampli opérationel
multimeter = multimètre
multimeter Settings = Réglages du multimètre
FunctionGenerator Settings = Réglages du générateur de fonction
Voltage Source Settings = Réglages de la source de tension
Current Source Settings = Réglages de la source de courant
Powersw Settings = Réglages de l'interrupteur
Resistor Settings = Réglages de la résistance
Capacitor Settings = Réglage de la capacité
Diode Settings = Réglages de la diode
voltPowersw Settings = Réglages 
Inductor Settings = Réglages de l'inductance
VCVS Settings = Réglages de la source de tension contrôlée par la tension
CCCS Settings = Réglages de la source de courant contrôlée par le courant
VCCS Settings = Réglages de la source de tension contrôlée par le courant
CCVS Settings = Réglages de la source de courant contrôlée par la tension
JFET Settings = Réglages du JFET
FET Settings = Réglages du FET
Transmission Line Settings = Réglages de la ligne de transmission
Oscilloscope Settings = Réglages de l'oscilloscope
XFMR Settings = Réglages du transformateur
LOGIC Settings = Réglages de la logique
LOGICSTATE Settings = Réglages de l'état logique
DIGITALCLOCK Settings = Réglages de l'horloge numérique
Potentiometer Settings = Réglages du potentiomètre
MUTUAL_INDUCTORS Settings = Réglages de l'inductance couplée
NE555 Settings = Réglages du NE555
THREE_PHASE Settings = Réglages du triphasé
Logic_Probe Settings = Réglages de la sonde logique
78XX Settings = Réglages du 78XX
79XX Settings = Réglages du 79XX
OPAMP5PEE Settings = Réglages du OPAMP5PEE
OPAMP5PEECN Settings = Réglages du OPAMP5PEECN
OPAMP3PEE Settings = Réglages du OPAMP3PEE
OPAMP3PEECN Settings = Réglages du OPAMP3PEECN
DELAY_FUSE Settings = Réglages du fusible temporisé
Ratio = Rapport
K[%]
Model = Modèle
States = États
Voltage[V]
Voltage gain[V/V]
Current gain[A/A]
Transconductance[Mho]
Transresistance[Ω]
Voltage Source Type = Type de source de tension
Current Source Type = Type de source de courant
multimeter type = type de multimètre
power type = type d'alimentation
Voltmeter Resistance(R)(Ω) = Résistance du voltmètre (R)(Ω)
Amperometer Resistance(R)(Ω) = Résistance de l'ampèremètre (R)(Ω)
mu.V = mu.V
mu.A = mu.A
Sine Wave = Onde sinusoïdale
Triangular Wave = Onde triangulaire
Rectangular Wave = Onde carrée
AC = CA
DC = CC
SINE = Sinus
PULSE = Impulsion
EXP = Exponentielle
SFFM = Modulation de fréquence à fréquence unique 
PWL = Linéaire par morceaux
B.spice = B.spice
DC Value[V]
DC Value[A]
DC offset[V]
DC offset[A]
Amplitude[V]
Amplitude[A]
Freq[Hz]
Theta[1/s]
Tdelay[s]
Phi[deg]
Tperiod[s]
Ton[s]
Tfall[s]
Trise[s]
Von[V]
Von[A]
Vinitial[V]
Vinitial[A]
Vpulsed[V]
Vpulsed[A]
Rise Delay[s]
Rise Tau[s]
Fall Delay[s]
Fall Tau[s]
Carrier Freq[Hz]
Modulation Index = Index de mudulation
Signal Freq[Hz]
Time[s]
Value[V]
Value[A]
Waveforms = Formes d'onde
Duty cycle[%]
Amplitude[Vp]
Offset[V]
Rise/Fall Time[sec]
Capacitance[F]
sComponent = 
Inductance[H]
Gbw = 
Slewrate = Vitesse de balayage
Avol = 
Rout(Ω) = Rsortie(Ω)
Rin(Ω) = Rentrée(Ω)
Ibias[A]
Inhi[V]
Inlo[V]
Isc[A]
Outhi[V]
Outlo[V]
Vabsmax[V]
Vmin[V]
Iq[A]
Cin[F]
high = haut
low = bas
Oscilloscope = Oscilloscope
Logic Analyzer = Analyseur logique
Channel_A = Canal_A
Channel_B = Canal_B
Channel A = Canal A
Channel B = Canal B
Time = Temps
Reverse = Opposé
Simulation file exceed = Dépassement de la taille du fichier de simulation
The simulation file is too large and has been stopped for performance reasons. = Le fichier de simulation est trop grand et a été arrêté pour des questions de performance.
Timebase = Base de temps
Scale: = Échelle:
X pos.(Div): = Pos. X(div):
Y pos.(Div): = Pos. Y(div):
View meter... = Voir le compteur...
The circuit has components without simulation model: = Le circuit a des composants sans modèle de simulation:
Your simulation interval is too short to simulate, please wait 5 seconds later and try again; if still show this message, may be you simulated over 500 times the maximum simulation times per day. = Votre intervalle de simulation est trop court pour simuler, veuillez patienter 5 secondes avant de réessayez ; si ce message s'affiche toujours, vous avez peut-être simulé plus de 500 fois qui est le nombre maximal de simulations par jour.
Resistor1_US = Résistance1_US
Resistor1_EU/IEC = Résistance1_EU/IEC
Resistor1_3D = Résistance1_3D
Capacitor1_US = Condensateur1_US
Capacitor1_EU/IEC = Condensateur1_EU/IEC
Capacitor1_3D = Condensateur1_3D
Rheostat_US = Rhéostat_US
Rheostat_EU/IEC = Rhéostat_EU/IEC
Rheostat_3D = Rhéostat_3D
Capacitor_Electrolytic_US = Condensateur_Électrolytique_US
Capacitor_Electrolytic_EU/IEC = Condensateur_Électrolytique_EU/IEC
Capacitor_Electrolytic_3D = Condensateur_Électrolytique_3D
Inductor_US = Inductance_US
Inductor_EU/IEC = Inductance_EU/IEC
Inductor_3D = Inductance_3D
Resistor2_US = Résistance2_US
Resistor2_EU/IEC = Résistance2_EU/IEC
Resistor2_3D = Résistance2_3D
Multimeter = Multimètre
Multimeter_3D = Multimètre_3D
Oscilloscope = Oscilloscope
Oscilloscope_3D = Oscilloscope_3D
Signal_Generator = Générateur_de_Signal
Signal Generator_3D = Générateur_de_Signal_3D
Wattmeter = Wattmètre
Wattmeter_3D = Wattmètre_3D
NSSWS1080T_3D = 
Voltage_Source_VDC = Source_de_Tension_VCC
Voltage_Source_VSin = Source_de_Tension_VSinus
Voltage_Source_VPULSE = Source_de_Tension_VImpulsion
Voltage_Source_VEXP = Source_de_Tension_VExponentielle
Voltage_Source_VSFFM = Source_de_Tension_VFréquenceModulée
Voltage_Source_VPWL = Source_de_Tension_VLinéaire
Voltage_Source_V_Behavioral_Source = 
Current_Source_IDC = 
Current_Source_ISin = 
Current_Source_IPULSE = 
Current_Source_IEXP = 
Current_Source_ISFFM = 
Current_Source_IPWL = 
Current_Source_I_Behavioral_Source = 
CCCS_1 = 
CCCS_2 = 
CCVS_1 = 
CCVS_2 = 
VCCS = 
VCVS = 
Three_Phase_Wye_Load = Charge_Triphasée_En_Étoile
Three_Phase_Delta_Load = Charge_Triphasée_En_Triangle
78XX = 78XX
79XX = 79XX
555 = NE555
555_3D = NE555_3D
Transformer_US = Transformateur_US
Transformer_EU/IEC = Transformateur_EU/IEC
Transformer_Center_Tapped_US = Transformateur_Point_Milieu_US
Transformer_Center_Tapped_EU/IEC = Transformateur_Point_Milieu_EU/IEC
Mutual_Inductor_US = Inductance_Couplée_US
Mutual_Inductor_EU/IEC = Inductance_Couplée_EU/IEC
Mutual_Inductor2_US = Inductance_Couplée2_US
Mutual_Inductor2_EU/IEC = Inductance_Couplée2_EU/IEC
OR2EE_US = 
OR3EE_US = 
OR4EE_US = 
OR2EE_CN = 
OR3EE_CN = 
OR4EE_CN = 
NOR2EE_US = 
NOR3EE_US = 
NOR4EE_US = 
NOR2EE_CN = 
NOR3EE_CN = 
NOR4EE_CN = 
AND2EE_US = 
AND3EE_US = 
AND4EE_US = 
AND2EE_CN = 
AND3EE_CN = 
AND4EE_CN = 
NAND2EE_US = 
NAND3EE_US = 
NAND4EE_US = 
NAND2EE_CN = 
NAND3EE_CN = 
NAND4EE_CN = 
XOR2EE_US = 
XOR2EE_CN = 
XNOR2EE_US = 
XNOR2EE_CN = 
Digital_Clock_1Hz = Horloge_Numérique_1Hz
Logicstate_0 = État_Logique_0
Logicstate_1 = État_Logique_1
Logic_Probe = Sonde_Logique
Buffee = 
INVEE_US = 
INVEE_CN = 
Schmittbuffee = 
LM358N_US = 
LM358N_CN = 
OPAMP3PEE_US = 
OPAMP3PEE_CN = 
OPAMP5PEE_US = 
OPAMP5PEE_CN = 
Voltage_Controlled_Switch = Interrupteur_Contrôlé_par_Tension
Current_Controlled_Switch = Interrupteur_Contrôlé_par_Courant
FUSE = Fusible
Delay_Fuse = 
Transmission_Line = Ligne_de_Transmission
Crystal = Quartz
DFFEE = 
TFFEE = 
JKFFEE = 
SRFFEE = 
SRLATCHEE = 
SRNANDFFEE = 
SRNORFFEE = 
INVTSEE = 
INVODEE = 
Schmittbuffee = 
Cbuffer = 
SPDT_Open = 
SPDT_Close = 
SPST_Close = 
SPST_Open = 
Fast_Crystal = 
Lamp = Ampoule
BCD_Segment = 
Seven_Segment = 7_Segments
Traffic_Light = 
Lamp Settings = Réglages de l'ampoule
Power[W]
Dropout Voltage[V]
Current[A]
Threshold[V]
Clock Rate = Fréquence d'horloge
TrafficLight Settings = 
BCDSegment Settings = 
SevenSegment Settings = Réglages de l'afficheur 7-segments
SPDT Settings = 
SPST Settings = 
LogicAnalyzer Settings = Réglages de l'analyseur logique
Fuse Settings = Réglages du fusible
Wattmeter Settings = Réglages du wattmètre
open = ouvrir
close = fermer
Common Anode = Anode commune
Common Cathode = Cathode commune
AC Amplitude = Amplitude CA
AC Phase = Phase CA
There are some parts haven't spice model, please use "EElib" and "Spice Symol" at "Libraries" of "Simulation" mode, or you can assign the spice model for them: = Certains composants n'ont pas de modèle Spice, veuillez utiliser "EElib" et "Spice Symbol" dans "Bibliothèques" du mode "Simulation", ou vous pouvez leur attribuer le modèle Spice.

#Pin
Pin Attributes = Attributs de la broche
Orientation = Orientation
Line 45° = Ligne à 45°
Line 90° = Ligne à 90°
Arc 45° = Arc à 45°
Arc 90° = Arc à 90°
Free Angle = Angle libre
Start X = Début X
Start Y = Début Y
Length = Longueur
Name = Nom
name = nom
Number = Nombre
Spice Pin Order = Ordre des broches Spice
Display Number = Afficher le numéro
Clock = Horloge
Show = Montrer
Electric = Électrique

#Junction
Junction Attributes = Attibuts de la jonction
X Location = Position X
Y Location = Position Y
Size = Taille
Color = Couleur

#Net Label
Net Label = Étiquette de l'interconnexion

#Part
Prefix = Préfixe

#Image Attributes and Dialog
Add Image = Ajouter une image
Image Attributes = Attibuts de l'image
Image URL = URL de l'image
Input an image URL = Entrez l'URL de l'image
Invalid image URL = URL de l'image invalide
Invalid Prefix = Préfixe invalide
Failed to load the image = Échec au chargement de l'image
Image URL contains special characters = L'URL de l'image contient des caractères spéciaux
From Web URL = Depuis une URL Web
From Local Computer = Depuis l'ordinateur local
Please select a png/gif/jpg file. = Veuillez choisir un fichier png/gif/jpg.
Please select an image file. = Veuillez choisir le fichier d'une image.
Select an image file = Sélectionnez un fichier image
Insert Image to PCB = Insérer une image sur le circuit imprimé
Tolerance = Tolérance
tolerance = tolérance
capacitance = capacité
frequency = fréquence
Rated Voltage = Tension nominale
Rated Current = Courant nominal
resistance = résistance
Resistance = Résistance
Resistance[Ω]
inductance = inductance
Operating Temperature = température d'utilisation
Shape Invert = Inverser la forme
Image Size = Taille de l'image
Color Tolerance = Tolérance de couleur
Simplify Level = Simplifier le niveau
Corner Threshold = Seuil d'angle

#PCB Canvas Attributes
Units = Unités
Snap Size = Taille d'accrochage
Other = Autre
Routing Width = Largeur de routage
[router]
Routing Width = Largeur de routage
[/router]
Please using hotkey {0}{shiftw}{1} or {2}{tab}{3} to change track width while on routing. = Veuillez utiliser le raccourci clavier {0}{shiftw}{1} ou {2}{tab}{3} pour modifier la largeur de la piste pendant le routage.
Routing Angle = Angle de routage
Routing Conflict = Conflit de routage
Remove Loop = Supprimer la boucle
Cut SilkScreen = Couper la sérigraphie
Grid = Grille
Grid 90 = Grille 90
Grid 45 = Grille 45
Copper Zone = Zone de cuivre
Visible = Visible
Invisible = Invisible
Ignore = Ignorer
Block = Bloc
RoundTrack = Piste Ronde

#Track
Track Properties = Propriétés de la piste
Layer = Couche
Net = Interconnexion
Start X = Début X
Start Y = Début Y
End X = Fin X
End Y = Fin Y
ID = Identifiant

#Pad Properties
Pad Properties = Propriétés de la pastille
Shape = Forme
Hole(D) = Perçage (D)
Center X = Centre X
Center Y = Centre Y
Round = Rond
Oval = Ovale
Hole Shape = Forme du trou 
Slot = Fente
Hole(Length) = Trou (Longueur)
Plated = Plaqué
None = Aucun
Paste Mask Expansion = Extension de masque de pâte
Solder Mask Expansion = Extension de masque de soudure

#Via Properties
Via Properties = Propriétés du via
Diameter = Diamètre
Drill Diameter = Diamètre du perçage

#Hole Properties
Hole Properties = Propriété du trou


#TEXT
Text Properties = Propriétés du texte
Line Width = Largeur de ligne
Rotation = Rotation
Fonts Management = Gestion des polices

#Dimension Attributes
Dimension Attributes = Attributs de la dimension

#Footprint Attributes
Component Attributes = Attributs du composant
Display Prefix = Affiche le préfixe
Pin Name = Nom de la broche
Pin Number = Numéro de la broche
Spice Pin Number = Numéro de la broche Spice
Graphics = Graphique
Pattern = Modèle

#Arc Properties
Arc Properties = Propriétés de l'arc de cercle
Start Angle = Angle du début
End Angle = Angle de fin
Rotation Direction = Sens de rotation

#Rect Properties
Rect Properties = Propriétés du rectangle
Round radius = Rayon de l'arrondi

#Circle Properties
Circle Properties = Propriétés du cercle
Radius = Rayon

#CopperArea Properties
CopperArea Properties = Propriétés de la zone de cuivre
Clearance = Espacement
Pad Connection = Connection aux pastilles
Direct = Directe
Spoke = Rayon
Keep Island = Conserver les zones orphelines
Fill Style = Style de remplissage
CopperArea conflict: copper area outlines in same layer with different net names must not overlap = Conflit de zones de cuivre : les différentes zones de cuivre d'une même couche ne peuvent pas se superposer.
Copper area rebuild complete! You can set "Copper Zone" as "Visible" at the right-hand property panel after single click the empty area. = Reconstruction de la zone de cuivre terminée ! Vous pouvez définir "Zone de cuivre" comme "Visible" dans le panneau de propriétés de droite après un simple clic sur la zone vide.
Please create board outline first. = Veuillez d'abord créer le contour de la carte.
Board outlines are not closed. = Le contour de la carte n'est pas fermé.
Rebuild CopperArea = Reconstruire les zones de cuivre
Edit Points = Éditer les points
Direct = Directe
Spoke = Rayon
No Solid = Non solide
Board Cutout = Contours de carte
Solid = Solide
[copperArea]
None = Aucun
[/copperArea]

#Custom Attributes
Custom Attributes = Attributs personnalisés
Fixed Attributes = Attributs fixes
Add new parameter = Ajouter un nouveau paramètre
Add New Parameter = Ajouter un Nouveau Paramètre
Add New Supplier = Ajouter un nouveau fournisseur
Mounted = Monté
Unknown = Inconnu

Custom = Personnalisé
Scan the QR code below and open it on the mobile side = Scannez le QR-code ci-dessous et ouvrez le sur votre mobile
How to create a single layer PCB = Comment créer un circuit imprimé simple face
Currently doesn't support layout single layer directly, please refer at: = Actuellement, ne prend pas en charge directement la disposition à une seule couche, veuillez vous référer à :

#Dialog Register
Create an account = Créer un compte
Username = Nom d'utilisateur
Password = Mot de passe
Confirm Password = Confirmer le mot de passe
Email = Adresse e-mail
Please read this before you register = Veuillez lire ceci avant de vous enregistrer
Hi {username} = Salut {username}

#Dialog lostPassword
Lost Password... = Mot de passe oublié...
Find the password using your email = Récupérer le mot de passe avec votre adresse e-mail



#Dialog Login
Login = S'identifier
Username or Email = Identifiant ou mot de passe
Remember Me = Se souvenir de moi
Third party = Tierce partie
Login and Register = Connectez-vous et inscrivez-vous
Your login information seems expired, please login again. Don't need to close the opening files, you can continue to save them after login. = Vos informations de connexion semblent expirées, veuillez vous reconnecter. Vous n'avez pas besoin de fermer les fichiers ouverts, vous pouvez continuer à les enregistrer après la connexion.

#Dialog Reset Password
Reset a password using your email = Réinitialiser un mot de passe en utilisant votre e-mail
Your registered email = Votre email enregistré

#Dialog Reaction
Re-send an activation code to your email = Renvoyer un code d'activation dans votre e-mail

#Dialog Invite
Invite friends to register = Inviter des amis à s'enregistrer
Your friend's email = L'e-mail de votre ami

#Dialog Add A New Parameter
Add a new parameter = Ajouter un nouveau paramètre
Key = Clé
Value.new_para = 
In BOM = Dans la nomenclature
Add into BOM = Ajouter à la nomenclature
Invalid key = Clé invalide
This field is required. = Ce champ est obligatoire.

#Dialog Change Your Password
Change your password = Changer votre mot de passe
Old password = Ancien mot de passe
New Password = Nouveau mot de passe
Confirm Password = Confirmez le mot de passe

#Dialog Create New Design
Save as a New Project = Enregistrer comme nouveau projet
Save as a schematic = Enregistrer comme schéma
Save as Symbol = Enregistrer comme symbole
Save as a spice Symbol = Enregistrer comme symbole Spice
Save as a spice subckt = Enregistrer comme sous-circuit Spice
YOU MUST CREATE A SPICE SYMBOL WITH EXACTLY THE SAME NAME AS THIS SUBCKT = VOUS DEVEZ CRÉER UN SYMBOLE SPICE AVEC EXCATEMENT LE MEME NOM QUE CE SOUS-CIRCUIT
Save as a PCB file = Enregistrer comme circuit imprimé
Save as Footprint = Enregistrer comme empreinte
Save as a Schematic Module = Enregistrer comme module de schéma
Save as a PCB Module = Enregistrer comme module de circuit imprimé
Save as 3D Model = Enregistrer comme modèle 3D
Save as a WaveForm = Enregistrer comme forme d'onde
Title = Titre
Share = Partager
Add file = Ajouter un fichier
Visibility = Visibilité
Allow Comments = Autoriser les commentaires
Public (Anyone can see this project but only you can modify it.) = Publique (Tout le monde peut consulter ce projet mais Vous seul pouvez le modifier.)
Private (Only you can see and modify this project) = Privé (Vous seul pouvez voir ou modifier ce projet.)
Create new project success! = Création du nouveau projet réussie!
You can now create files under this project = Vous pouvez maintenant créer des fichiers sous ce projet.
This file must be saved under a project, choose other project or create a new project = Ce fichier doit être enregistré sous un projet, choisissez un autre projet ou créez un nouveau projet
Please login to save this kind of document = Veuillez vous connecter pour enregistrer ce type de document
Duplicated project title = Titre du projet en double
#Duplicated document title
Project does not exist = Projet inexistant
Document does not exist = Document inexistant
document not exists = le document n'existe pas

Categories = Catégories
Project = Projet
Short description = Description brève
Content = Contenu
Modify this project info. = Modifier les informations de ce projet.
Modify this file info. = Modifier les informations de ce fichier.
Notice = Avis
Search for it before creating a new one. = Recherchez-le avant d'en créer un nouveau.
Manufacturer Part Number = Référence fabricant
Supplier = Fournisseur
Or = Ou
Supplier Part = Pièce fournisseur
Supplier Part Number = Numéro de pièce du fournisseur
Link = Lien
link = lien
The professional function please refer at: = 

#Dialog Clone My Part
#Clone it to a project
#Clone it, then edit it
Clone your file = Dupliquer votre fichier

#Dialog Subckt
Attach a Subckt to this spice symbol = Lier un sous-circuit à ce symbole Spice
Subckt string = 
Spice symbol title just allow [0-9][a-z][A-Z] and _

#Design Manager
Design Manager = Gestionnaire de conceptions
Nets = Interconnexions
DRC Errors = Erreurs de règles de conception
Are you sure you want to unroute this net? = Êtes-vous sûr de vouloir supprimer le routage de cette interconnexion ?
Unroute = Annuler le routage
Track Length = Longueur de piste
Via/Hole Outer Size = Taille externe du via/trou
Filter nets = Filtrer les interconnexions
Design Rule Checking = Vérification des règles de conception
Board Outline = Contour de la carte
Plane Zone = Zone pleine
[drcRule]
Width = Largeur
DRC Width = Largeur des règles de conception
Length = Longueur
DRC Length = Longueur des règles de conception
Drill Diameter = Diamètre de forage 
DRC Drill Diameter = Diamètre de forage des règles de conception
Diameter = Diamètre
DRC Diameter = Diamètre des règles de conception
Object = Objet
DRC Clearance = Dégagement des règles de conception
[/drcRule]
#It will take a while to unroute this net, do you want to continue?
More than one netlabel is found in wire, please checked whether this is correct, if you design it on purpose, please ignore this warning. = Plus d'une étiquette d'interconnexion est trouvée sur le fil, veuillez vérifier si cela est correct, si vous le concevez exprès, veuillez ignorer cet avertissement.
Incomplete net, a complete net should contain two or more pins, if you design it on purpose, please ignore this warning. = Interconnexion incomplète, une interconnexion complète doit contenir deux ou plusieurs broches, si vous le concevez exprès, veuillez ignorer cet avertissement.
This netlabel is not connected with any pin. = Cette étiquette d'interconnexion n'est connectée à aucune broche.
Incomplete connection, please check. = Interconnexion incomplète, veuillez vérifier.
The clearance between two objects is less than the Design Rule Checking (DRC) clearance which has different nets. = 
The diameter is less than Design Rule Checking (DRC) diameter = 
The drill diameter is less than Design Rule Checking (DRC) drill diameter = 
The track length is longer than Design Rule Checking (DRC) track length = 
The track width is less than Design Rule Checking (DRC) track width = 

#Dialog Simulation
Show your simulation report = Afficher votre rapport de simulation
Download netlist = Télécharger la netListe
Run = Démarrer
Components = Composants

#Dialog Import
Import file from your computer = Importer un fichier à partir de votre ordinateur
Maximum file size: 30 MB = Taille maximale du fichier : 30 Mo
Maximum file size: 100 MB = Taille maximale du fichier : 100 Mo
Chose file = Choisir le fichier
File Operation = Opération sur le fichier
Import File = Importer un fichier
Extract Libs = Extraire les bibliothèques
Import File and Extract Libs = Import de fichiers et extraction de bibliothèques
File type = Type de fichier
The file size is too large. = La taille du fichier est trop grande.
Please selected the file type. = Veuillez choisir le type du fichier.
No component was found! = Aucun composant n'a été trouvé !
Import successfully = Import réussi
Import failed = Échec de l'import
Click OK to continue with the import = Cliquez sur OK pour continuer l'import
Select None = Sélectionnez Aucun

#Dialog Modify Symbol Information
Modify symbol information = Modifier les informations du symbole
Spice Prefix = Préfixe Spice
Hide Pin = Masquer la broche
Pin Manager = Gestionnaire de brochage
When a power pin is hidden, it will be marked as netlabel, you don't need to wire it. If you use it as simulation, please show it or create a GND/VCC Net for it. = Lorsqu'une broche d'alimentation est cachée, elle sera marquée comme étiquette de connexion, vous n'avez pas besoin de la câbler. Si vous l'utilisez dans une simulation, veuillez la rendre visible ou créer une connexion GND/VCC pour cela.
Assign = Assigner
Supplier.bom = 
LCSC.bom = 
Price = Prix
Quantity.bom = 
Package.bom = 
Components.bom = 
Manufacturer Part.bom = 
Manufacturer.bom = 

One-click Purchasing at LCSC = Achats en un clic chez LCSC
Order Parts/Check Stock = Commander des pièces/vérifier le stock
Export BOM = Exporter la nommencature
Export PCB BOM = Exporter la nomenclature du circuit imprimé
Export Schematic BOM = Exporter la nomenclature du schéma
ID.bom = 
Name.bom = 
[bom]
Name = Nom
LCSC Assembly = Assemblage LCSC
Value = Valeur
ID = Identifiant
Supplier = Fournisseur
LCSC = LCSC
Price = Prix
Quantity = Quantité
Package = Boîtier
Components = Composant
Manufacturer = Fabricant
[/bom]
Manufacturer Part = Pièce du fabricant

#Dialog Run
Run your simulation = Lancer la simulation
Transient = Transitoires
Maximum Timestep = Pas de temps maximum
Stop Time = Heure de fin
Start Time = Heure de début

AC Analysis = Analyse CA
Type of Sweep = Type de balayage
Number of points = Nombre de points
Start Frequency = Fréquence de départ
Stop Frequency = Fréquence de fin

DC sweep = Balayage CC
Source to Sweep = Source à balayer
Start Value = Valeur initiale
Stop Value = Valeur finale
Increment = Incrément
DC Transfer = Transfert CC
Output = Sortie
Source = Source

DC op pnt = Point de fonctionnement CC
Compute the DC operating point treating capacitances as opens and inductances as shorts = Calculer le point de fonctionnement CC en traitant les condensateurs comme des circuits ouverts et les bobines comme des court-circuits

#Dialog Share Info
Active File = Fichier actif
Active Project = Projet actif
Embed it in your html files. = Intégrez-le dans vos fichiers HTML.
Share it by e-mail, IM, blog, etc. = Partagez-le par e-mail, messagerie instantanée, blog, etc.
BBCode (used by many online discussion forums) = BBCode (utilisé par beaucoup de forums en ligne)
HTML code = Code HTML
QRCode (Share your schematic address by QRCode ) = QR Code (partager l'adresse de votre schéma avec un QRCode)
Short Url = URL courte
Share a copy of this document = Partagez une copie de ce document
Readonly = Lecture seule
Editable = Modifiable
Active file's owner project page = Page du projet du propriétaire du fichier actif
Active project editor page = Page de l'éditeur de projet actif
Active file image URL = URL de l'image du fichier actif

#Dialog Document Recovery
All Projects = Tous les projets
Document Recovery = Récupération de document
Unsaved files = Fichiers non sauvegardés
Please select a file! = Veuillez choisir un fichier !
Please expand the folder first, then select a document to recover. = Veuillez d'abord développer le dossier, puis sélectionnez un document à récupérer.
Are you sure you want to remove this backup? = Êtes-vous sûr de vouloir supprimer cette sauvegarde ?

#Dialog Find Libs
Search = Rechercher
Search Results = Résultats de la recherche
Search and press Enter = Rechercher et appuyer sur Entrée
Keywords at least 3 characters = Mots-clés d'au moins 3 caractères
Assembled = Assemblé
Verified = Vérifié
In stock = En stock
{page} of {pagecount} pages = {page} de {pagecount} pages
Common Modules = Modules communs
User Contributions = Contributions utilisateur
More = Plus
Add Favorite = Ajouter un favori
Remove Favorite = Supprimer un favori
Add Sub Part = Ajouter une sous-partie
Untagged = Non tagué
Package = Boîtier
package = boîtier
Title(PartNO) = Titre (NoPièce)
No Data! = Pas de donnée!
Quantity = Quantité
Manufacturer Part = Pièce du fabricant
manufacturer Part = pièce du fabricant
Manufacturer = Fabricant
manufacturer = fabricant
voltage = Tension
Library = Bibliothèque
LCSC Assembled = Assemblé par LCSC
JLCPCB Assembled = Assemblé par JLCPCB
User Contributed = Contribution utilisateur
Symbol = Symbole
Follow = Poursuivre
Types = Types
Classes = Classes
power = puissance
Power = Puissance
LCSC Part# = Référence LCSC
Stock = Stock
Report Error... = Signaler une erreur...
Report Error = Signaler une erreur
Thanks for your feedback! = Merci pour votre retour !
Report error success, thanks for your report! = Signalement d'erreur réussi, merci pour votre signalement !
The content must be at least 2 characters! = Le contenu doit comporter au moins 2 caractères !
This library is user contributed, please check before using. = Cette bibliothèque est une contribution utilisateur, veuillez vérifier avant de l'utiliser.
[lib]
All = Tous
System = Système
Personal = Personnelle
Created = Créée
Favorite = Favorite
No Team found. Please join or create a team first. = Aucune équipe trouvée. Veuillez d'abord rejoindre ou créer une équipe.
Create a team = Créer une équipe
No follow user found. Please follow your friend first. = Aucun utilisateur suivi trouvé. Veuillez d'abord suivre votre ami.
[/lib]


BUY = ACHETER
In Stock = En stock
Out of Stock = En rupture de stock
Minimum = Minimum
Distributor = Distributeur

Capacitance = Capacité
Frequency Tolerance = Tolérance de fréquence 
Power (Watts) = Puissance (Watts)
Power - Max = Puissance - Max
Frequency = Fréquence
Voltage Rating(Vdc,Vac) = Tension nominale (Vcc, Vca)
Voltage = Tension
Current Rating = Intensité nominale
Rated current = Courant nominal
Resistance (Ohms) = Resistance (Ohms)
Resistance(Ohms) = Resistance(Ohms)
Inductance = Inductance
FET Type = Type FET
Current Rating(Max) = Courant nominal(Max)
Impedance @ Frequency = Impédance @ Fréquence
Voltage - Input (Max) = Tension d'entrée (Max)
Voltage - Input (Min) = Tension d'entrée (Min)
Voltage - Supply = Tension d'alimentation
Voltage - Max = Tension Max
Current - Output = Courant en sortie

#Dialog Export Your Works
Export your works = Exporter votre travail
Export to = Exporter vers
Zoom = Zoom
Image Type = Type d'image
Qualify = Qualifier
0 means real size = 0 signifie taille réelle
Merged layer = Couche fusionnée
Separated layer = Couche séparée
Paged layer = Couche paginée
Layer = Couche
Export = Exporter
Mirror = Mirroir
TopLayer = Côté composants
BottomLayer = Côté cuivre
TopSilkLayer = Sérigraphie côté composants
Protractor Attributes = Attributs du rapporteur
BottomSilkLayer = Sérigraphie côté cuivre
#后面还有个BoardOutline,仅仅一个字母大小写的差别
BoardOutLine = Contour de carte
TopAssembly = Assemblage supérieur
BottomAssembly = Assemblage inférieur
Mechanical = Mécanique
DocumentLayer = Couche documentation
Inner{number} = Interne{number}
Substrate{number} = Substrat{number}
Color = Couleur
Full Color = Pleine couleur
Canvas Setting = Réglages du canevas
Full Graphics = Graphiques complets
Assembly Drawings = Dessins d'assemblage
Object Outlines = Contours d'objet
Invalid file format = Format de fichier invalide
Failed to export file = Échec de l'exportation du fichier
Download now = Télécharger maintenant
Wire Width = Largeur de câble
Sheet = Feuille
Merged sheet = Feuille fusionnée
Separated sheet = Feuille séparée
Engine = Moteur
Exporting PDF = Export PDF
Export 3D Model = Exporter le modèle 3D
[exportDocument]
Size = Taille
[/exportDocument]

#Dialog Import Changes
Confirm Importing changes information = Confirmer l'importation des changements
You can't undo this operation, Please run a Design Rule Checking (DRC) after this operation. = Vous ne pouvez pas annuler cette opération, veuillez exécuter une vérification des règles de conception (DRC) après cette opération.
Apply Changes = Appliquer les changements
This is a simple Design Rule Checking (DRC). = C'est une simple vérification des règles de conception (DRC).
It just can help you to find the obvious errors = Cela peut juste vous aider à trouver les erreurs évidentes
There are some unfinished nets, do you want to check the nets first? = Il y a des interconnexions inachevées, voulez-vous d'abord les vérifier ?
Yes, Check Nets = Oui, vérifier les interconnexions
No, Keep Going = Non, continuer

#Dialog Layer Manager
Configured = Configurée
Layer Name = Nom de la couche
TopPasterLayer = Couche dessus
BottomPasterLayer = Couche dessous
TopSolderLayer = Couche Cuivre dessus
BottomSolderLayer = Couche Cuivre dessous
TopPasteMaskLayer = Couche de masque de pâte supérieure
BottomPasteMaskLayer = Couche de masque de pâte inférieure
TopSolderMaskLayer = Couche de masque de soudure supérieure
BottomSolderMaskLayer = Couche de masque de soudure inférieure
ComponentShapeLayer = Couche de forme de composant
LeadShapeLayer = Couche de forme de plomb
ComponentMarkingLayer = Couche de marquage de composant
Ratlines = Chevelu
Ratlines Color = Couleur du chevelu
Manage Colors = Gérer les couleurs
BoardOutline = Bordure du circuit imprimé
Multi-Layer = Multi-couche
Hole = Trou
DRCError = Erreurs de véricication Règles de Routage
Setting = Réglages
Drawing area = Zone de dessin
Export area = Exporter la zone
Transparency(%) = Transparence(%)
Copper Layer = Couche de cuivre
Signal = Signal
Plane = Plan
Non-Signal = Non-Signal
Other = Autre
Please delete all the objects of the layers first! The layers are: = Veuillez d'abord supprimer tous les objets des couches ! Les couches sont :
You are converting Signal Layer to Plane Layer, There're some non-track objects remain on following layers. Please delete the objects manually on the canvas. = Vous convertissez la couche de signal en couche de plan, il reste des objets non suivis sur les couches suivantes. Veuillez supprimer les objets manuellement sur le canevas.
Please delete all the objects of this layer first! = Veuillez d'abord supprimer tous les objets de cette couche !

#Dialog Fabrication Output
Create Files = Générer les fichiers
Check your {0}Gerber files{1} carefully before sending them to the factory = Vérifiez soigneusement vos {0}fichiers Gerber{1} avant de les envoyer à l'usine
Download free Gerber Viewer (gerbv) = Télécharger le visualiseur gratuir de fichiers Gerber (gerbv)
Before generating the Gerber files = Avant de générer les fichiers Gerber
Please check the packages size and orientation carefully. = Veuillez vérifier attentivement la taille et l'orientation des boîtiers.
Please check for Design Rule Checking (DRC) errors in the Design Manager. = Veuillez vérifier les erreurs de vérification des règles de conception (DRC) dans le gestionnaire de conception.
Please rebuild the copper area after modifying tracks and packages. = Veuillez reconstruire la zone de cuivre après avoir modifié les pistes et les boîtiers.
After generating the Gerber file, please use the {0}Gerber Viewer{1} to check whether it conforms to the design requirements. = Après avoir généré le fichier Gerber, veuillez utiliser le {0}Visualiseur de fichier Gerber{1} pour vérifier s'il est conforme aux exigences de conception.
Order at JLCPCB = Commander chez JLCPCB
Found the complicated polygon object can not be generated at Gerber, please remove or replace = Un objet polygone compliqué a été trouvé qui ne peut être généré dans le Gerber, veuillez le supprimer ou le remplacer
ID: {id}, Object: {object}, Location: {location} = Identifiant: {id}, Objet: {object}, Emplacement: {location}

#Dialog DRC
Item = Élément
Value = Valeur
value = valeur
Unit = Unité
Track Width = Largeur de piste
Track to Track = Piste à piste
Track to Pad = Piste à pastille
Pad to Pad = Pastille à pastille
Via to Via = Via à via
Via Hole Size = Taille de perçage du via
Realtime DRC = Vérification des règles de conception en temps-réel
{0} is too small! = {0} est trop petit !
Invalid DRC Rule = Règle de conception invalide
Rule = Règles
Via Diameter = Diamètre du via
Via Drill Diameter = Diamètre de perçage du via
Net List = Liste d'interconnexions
Rule = Règles
Set Rule = Définir un règle
Check Object to Copper Area = Vérifier l'objet dans la zone de cuivre
Show DRC Boundary while Routing = Afficher la limite de la RDC pendant le routage
Check Object to Board Outline = Vérifier le contour de l'objet à la carte
Rule name already exists! = Le nom de la règle existe déjà !
You should not delete default rule! = Vous ne devez pas supprimer la règle par défaut !
Rule list contains invalid rule setting! = La liste de règles contient un paramètre de règle non valide !
Duplicate rule name exists! = Le nom de règle en double existe !
via diameter is smaller than via drill diameter! = le diamètre du via est plus petit que le diamètre de perçage !
Currently rule name is not allowed to contain magical characters like . and $ = Actuellement, le nom de la règle ne peut pas contenir des caractères magiques tels que . et $
[drcRule]
All = Tous
[/drcRule]

#Dialog  Update PCB
Update PCB(Synchronizing PCB from schematics) = Mettre à jour le circuit imprimé (synchronisation du circuit à partir des schémas)


#Dialog Hotkey
Change Canvas Unit = Changer l'unité du canevas
Copy Selected Object(s) by Reference Point = Copier l(es) objet(s) sélectionné(s) par point de référence
Fullscreen = Plein écran
Undo the Previous Draw = Annuler le dessin précédent
Set Canvas Origin by Coordinate = Définir l'origine du canevas par coordonnée
Switch to the Next Signal Layer = Passer à la couche de signal suivante
Switch to the Previous Signal Layer = Passer à la couche de signal précédente
Switch object to top layer or bottom layer = Basculer l'objet vers la couche supérieure ou inférieure
Cycle Forward to the Next Open Tabbed Document = Cycler en avant au document de l'onglet ouvert suivant 
Cycle Backward to the Previous Open Tabbed Document = Cycler en arrière au document de l'onglet ouvert précédent
Switch to the Previous Layer(on the Numeric Keypad) = Passer à la couche précédente (sur le pavé numérique)
Switch to the Next Layer(on the Numeric Keypad) = Passer à la couche suivante (sur le pavé numérique)
Toggle Layers Which is Not Active = Baculer les couches qui ne sont pas actives
Hotkey Setting = Réglages des touches de raccourcis
Document Type = Type de document
Shortcut = Raccourci
Function = Fonction
ALL = TOUS
SCH = SCH
Rotate Selected Objects = Faire pivoter les objets sélectionnés
Scroll or Move Selected Left = Faire défiler ou déplacer la sélection vers la gauche
Scroll or Move Selected Right = Faire défiler ou déplacer la sélection vers la droite
Scroll or Move Selected Up = Faire défiler ou déplacer la sélection vers le haut
Scroll or Move Selected Down = Faire défiler ou déplacer la sélection vers le bas
Set canvas origin to the center grid of graphics in symbol; Set canvas origin to the center of pads in footprint. = Définissez l'origine du canevas sur le centre de la grille des graphiques dans le symbole ; définissez l'origine du canevas au centre des pastilles dans l'empreinte.
Cross Document Paste = Pâte document croisé
Explore & Find Components = Explorer et trouver des composants
Select All = Sélectionner Tout
Cancel Current Drawing = 
Save = Enregistrer
Drag Tool = Outil de déplacement
Draw Wire = Dessiner une Liaison
Draw Bus = Dessiner un Bus
Bus Entry = Entrée de Bus
Junction = Jonction
Net Flag GND = Étiquette d'interconnexion GND
Net Flag = Étiquette d'interconnexion
Draw Polyline = Dessiner une ligne multiple
Draw Polygon = Dessiner un polygone
Draw Bezier = Dessiner un Bézier
Draw Arc = Dessiner un arc
Draw Rect = Dessiner un rectangle
Draw Ellipse = Dessiner une élipse
Freehand Draw = Dessin à main levée
Freedraw = Dessin libre
Draw Text = Dessiner un texte
Edit Selected Symbol = Editer le symbole sélectionné
Draw Track = Dessiner un piste
Draw Circle = Dessiner un cercle
Cycle Select Object at Current Location = 
Draw Dimension = Dessiner les dimensions
Draw Connect = Dessiner une connection
Draw CopperArea = Dessiner une zone de cuivre
Change to TopLayer;<br/>Change Seleted Component's Layer to TopLayer; = Changer en Couche Supérieure ;<br/> Changer la couche sélectionnée des composants en couche supérieure ;
Change to BottomLayer;<br/>Change Seleted Component's Layer to BottomLayer; = Changer en Couche Inférieure ;<br/> Changer la couche sélectionnée des composants en couche inférieure ;
Change to Inner1 = Changer en Interne1
Change to Inner2 = Changer en Interne2
Change to Inner3 = Changer en Interne3
Change to Inner4 = Changer en Interne4
Highlight Net = Mettre en surbrillance l'interconnecion
Place Pad = Placer une pastille
Place Via = Placer un Via
Measure = Mesurer
Change Routing Angle = Changer l'angle de routage
Change Routing Conflict = Changer le conflit de routage
Decrease Routing Width = Diminuer la largeur de routage
Increase Routing Width = Augmenter la largeur de routage
Decrease Snap Size = Diminuer l'espacement
Increase Snap Size = Augmenter l'espacement
Change Copper Zone Visible or Invisible = Changer la zone de cuivre visible ou invisible
Rebuild All Copper Area = Reconstruire toutes les zones de cuivre
Toggle PCB Net Display = Basculer l'affichage des interconnexion du circuit imprimé
Show Attribute Dialog When Placing Object;<br/>Show Location Setting Dialog When Pasting Object(s) = Afficher la boîte de dialogue d'attribut lors du placement de l'objet ;<br/>Afficher la boîte de dialogue de réglage de l'emplacement lors du collage d'objets
Show Attribute Dialog When Placing Object;<br/>Show Absolute Offset Dialog When Selecting Object(s);<br/>Show Location Setting Dialog When Pasting Object(s) = Afficher la boîte de dialogue d'attribut lors du placement de l'objet ;<br/>Afficher la boîte de dialogue de décalage absolu lors de la sélection d'objets ;<br/>Afficher la boîte de dialogue de réglage d'emplacement lors du collage d'objets
Show Relative Offset Dialog When Selecting Object(s) = Afficher la boîte de dialogue de décalage relatif lors de la sélection d'objets
Open the FAQ Page = Ouvrir la page de la FAQ
Move Object(s) by Reference Point = Déplacer des objets par point de référence
Choose Favorite Track Width While Routing = Choisissez la largeur de piste préférée pendant le routage
Copy Selected Object(s) and Paste Repeatedly = Copier les objets sélectionnés et coller à plusieurs reprises

#My Projects Tree Menu
New Project = Nouveau projet
New Schematic = Nouveau schéma
New PCB = Nouveau circuit imprimé
New Spice Subckt = Nouveau sous-circuit Spice
Modify = Modifier
Delete = Supprimer
Add sub part = Ajouter une sous-partie
Clone = Dupliquer
Version History = Historique des versions
Refresh List = Rafraîchir la liste
Create New Project = Créer un nouveau projet
Delete = Supprimer
Attachment = Attachement
Archive = Archive
Transfer = Transférer

#Dialog Verify Package
Footprints Verification = Vérificaiton de l'empreinte

#Dialog Edit Polygon Pad points
Edit Points = Modifier les points
Center point is outside the pad = Le point central est à l'extérieur de la pastille
Hole should be inside the pad = Le trou doit être à l'intérieur de la pastille
Hole is draggable = Le trou est déplaçable

#My Part Tree Menu
Clone = Dupliquer
Reload parts = Recharger les éléments
Layers = Couches

#Dialog Preferences
Language = Langue
Display Name = Nom affiché
HotKey Sync = Raccourci Sync
My Theme Sync = Raccourci mon thème
Document Recovery Setting = Paramètre de récupération de document
Enable auto backup = Activer la sauvegarde auto
Maximum backup level = Niveau de sauvegarde maximal
Auto backup interval = Intervalle de sauvegarde automatique
minutes = minutes
Save to Server = Enregistrer sur le serveur
Load from Server = Charger à partir du serveur


#Dialog Schematic Library Wizard
Symbol Wizard = Assistant de symbole
Style = Style
Picture = Image
Pin Names = Nom des broches
Contributor = Contributeur
contributor = contributeur
owner = propriétaire

#Dialog Annotate
Annotate = Annoter
Scope = Pointer
Active Schematic only = Uniquement le schéma actif
All Opened Schematics = Tous les schémas ouverts
Method = Méthode
Re-annotate all = Tout ré-annoter
Keep existing annotation = Conserver les annotations existantes
Direction = Direction
Rows = Lignes
Cols = Colonnes
Reset = Remise à zéro

#Dialog Order
Order... = Commander...
PCB Qty. = Nombre de circuits imprimés
PCB Thickness = Épaisseur du circuit imprimé
PCB Dimension = Dimensions du circuit imprimé
Automatic calculation = Calcul automatique
PCB Color = Couleur du circuit imprimé
Green = Vert
White = Blanc
Blue = Bleu
Red = Rouge
Yellow = Jaune
Black = Noir
Purple = Mauve
Copper = Cuivre
Gold = Or
Silver = Argent
Surface Finish = Finition
Hasl = Brasure
Hasl(Lead Free) = Brasure(sans plomb)
ENIG = ENIG
E-Test = E-Test
Shipping Cost = Frais de port
Cost Estimate = Estimation du prix
Actual cost will be confirmed by email. = Le coût sera confirmé par e-mail
Shipping information = Informations sur la livraison
Address = Adresse
ZIP/Post code = Code postal
City = Ville
Country = Pays
Tel. = Tél.
After filling out the form above, we will email you with (i) the results of the Design Rule Checking (DRC), (ii) a quote and (iii) a payment link using Paypal. Shipping is normally one week from receipt of payment. = Après avoir rempli le formulaire ci-dessus, nous vous enverrons par e-mail (i) les résultats de la vérification des règles de conception (DRC), (ii) un devis et (iii) un lien de paiement via Paypal. L'expédition est normalement d'une semaine à compter de la réception du paiement.



#Dialog Hot Key config
Restore All Default Shortcuts = Restaurer tous les raccourcis par défaut
Save Changes = Enregistrer les modifications



#Dialog Polyline Maybe Wire
To connect electrical elements, please use Wire (W hotkey) and not Line (L hotkey). = Pour connecter des éléments électriques, veuillez utiliser le fil (touche de raccourci W) et non la ligne (touche de raccourci L).

Anonymous File = Fichier anonyme
Anonymous File can not be cloned, but you can open it, then save it as a new file. = Le fichier anonyme ne peut pas être cloné, mais vous pouvez l'ouvrir, puis l'enregistrer en tant que nouveau fichier.
Free Documents = Documents gratuits
You must close the file before delete it! = Vous devez fermer le fichier avant de le supprimer !
Offline Project = Projet hors ligne

#Message box
Confirmation = Confirmation
Alert = Alerte
Information = Information
information = information
Prompt = Prompt
Error = Erreur
error = erreur
error! = Erreur !
Warning = Attention
Imported ok! = Importation OK !
Some changes have not been saved. = Certaines modifications n'ont pas été enregistrées
Your file hasn't been saved. Please save first! = Votre fichier n'a pas été enregistré. Veuillez d'abord enregistrer !
Your file hasn't been saved. Are you sure you want to close it? = Votre fichier n'a pas été enregistré. Êtes-vous sûr de vouloir le fermer ?
Error! Please try again later. = Erreur! Veuillez réessayer plus tard.
Are you sure you want to reload this page? = Êtes-vous sûr de vouloir recharger cette page ?
Are you sure you want to leave this page? = Êtes-vous sûr de vouloir quitter cette page ?
Confirm Reload = Confirmer le rechargement
Confirm Close = Confirmer la fermeture
Reload this page = Recharger cette page
Leave this page = Quitter cette page
Stay on this page = Rester sur cette page
Don't reload = Ne pas recharger
No connect flag only can be placed on Pin dot or the wire which is connected one Pin. = L'étiquette de non connexion ne peut être positionnée que sur une broche ou sur un fil connecté qu'à une seule broche.
can not be placed on the wire which is placing No Connect Flag. = ne peut être positionné sur le fil qui a une étiquette de non connexion.
The footprint transfer to LCSC library class successfully = Le transfert d'empreinte vers la classe de bibliothèque LCSC avec succès
Device/Footprint goes into "SMT Device/Footprint Verified" list successfully = Le composant/l'empreinte entre dans la liste "Composant CMS/Empreinte vérifié" avec succès

Load failure! = Échec du chargement !
Load projects failed = Échec du chargement des projets
error info = Information sur l'erreur
error information = Information sur l'erreur
Guest can't create a new project. Please login! = Un invité ne peut pas créer de nouveau projet. Veuillez vous connecter !
Please create a project before you do this! = Vous devez d'abord créer un nouveau projet !
Add Part success = Ajout d'élément réussi
Click the new part and then edit it! = Cliquez sur le nouveau composant, puis modifiez-le !
Delete my work = Effacer mon travail
Delete my work. (Only deletes it from this list but not from the server) = Supprimer mon travail. (Ne le supprime que de cette liste mais pas du serveur)
Do you confirm this? = Confirmez-vous cela ?
Successfully deleted! = Effacement réussi !
Successfully Copied! = Copié avec succès !
Cloning success! = Clonage réussi !
Your title is too short! = Votre titre est trop court !
Remove this part = Supprimer l'élément
Find and Jump to ... = Chercher et aller à...
Please type the prefix, such as U1, R1, C1 = Veuillez saisir un préfixe (U1, R1, C1, ...)
Zoom as 1:1, you can print it and then create artwork for etching the PCB. = Zoom 100 %. Vous pouvez imprimer puis créer votre typon.
Exporting your works! = Exportation en cours !
Guests can't import a file. Please login! = Les invités ne peuvent pas importer un fichier. Vous devez vous inscrire !
Please create a project before you import a file! = Vous devez créer un projet avant d'omporter un fichier !
Import your LTspice file! = Importer votre fichier LTspice !
Open LTspice file = Ouvrir un fichier LTspice
Please make sure the selected LTspice file is a file saved in LTspice V and above. = 
Saved successfully! = Enregistrement réussi !
Save failed! = Échec de la sauvegarde !
Can not place parts into this document. = Vous ne pouvez pas placer d'éléments dans ce document.
User Package = Boîtier Utilisateur
System Package = Boîtier Système
File error = Erreur de fichier
Please save your file first! = Vous devez d'abord enregistrer votre fichier !
Email address is too short! = L'adresse email est trop courte !
You have not selected a file to upload. = Vous n'avez pas sélectionné de fichier à transférer.
Update = Mettre à jour
Import.Import Changes = 
No changes, the PCB already matches the schematic! = Aucun changement, le circuit imprimé correspond déjà au schéma !
Only public files can be shared = Seuls les fichiers publiques peuvent être partagés
Conversion to PCB has failed! = Erreur lors de la conversion en circuit imprimé !
Your username is too short! = Votre nom d'utilisateur est trop court !
Your password is too short, it must be more than 6 characters! = Votre mot de passe est trop court (6 caractères au minimum) !
Conflicting shortcut = Raccourci conflictuel
There is an empty PCB file. Please first run Convert Project To PCB... from the schematic = Le fichier cu circuit imprimé est vide. Vous devez d'abord lancer la conversion du projet en circuit imprimé...
This file has been modified, are you sure you want to run this simulation before saving it first? = Le fichier a été modifié. Voulez-vous quand même lancer la simulation ?
Please enter the Maximum Timestep! = Veuillez saisir la durée maximale d'un pas de simulation !
Please enter the Stop Time! = Veuillez saisir la fin de simulation !
All of these fields are needed. = Tous les champs sont requis.
Either your spice netlist is too big or the server is busy. Please try again later. = Votre netlist est trop grande ou le serveur est occupé. Réessayez plus tard.
Your spice netlist is too big! Try breaking your circuit into smaller simulatable blocks. = Votre netlist est trop grande ! Essayez de découper votre ciruit en blocs plus petits.
Too many users in simulation. Please try again later! = Trop d'utilisateurs font des simulations. Réessayez plus tard !
Due to limited server resources, please wait 10 seconds for the interval in every time simulation. = En raison des ressources limitées du serveur, veuillez attendre 10 secondes pour l'intervalle dans chaque simulation de temps.
Your circuit is too complex, we have not enough CPU resouce to support this simulation, please reduce your circuit as small as you can. = Votre circuit est trop complexe, nous n'avons pas assez de ressources CPU pour prendre en charge cette simulation, veuillez réduire votre circuit autant que possible.
Simulation is queuing, try again after 30s. = La simulation est en file d'attente, réessayez après 30 secondes.
Timeout = Délai d'attente
Demo accounts don't support simulation, please login first = Les comptes de démonstration ne prennent pas en charge la simulation, veuillez d'abord vous connecter
Please login first = Veuillez d'abord vous connecter
The schematic is showing errors, please check the simulation report carefully! = Le schéma comporte des erreurs, veuillez vérifiez le rapport de simulation attentivement !
Simulation too long, maybe your schematic is too complex. = La simulation est trop longue, peut-être que votre schéma est trop complexe.
Non-simulated file = fichier non simulé
This file can only be opened in standard mode. To open it, please switch to standard mode. = Ce fichier ne peut être ouvert qu'en mode standard. Pour l'ouvrir, veuillez d'abord basculer en mode standard.
Load your preferences success! = Chargement de vos préférences réussi !
Save your preferences success! = Enregistrement de vos préférences réussi !
Update subckt ok! = Mise à jour du sous-circuit réussie !
Clone your file = Dupliquer ce fichier
Please type a new file name = Veuillez saisir un nouveau nom de fichier
Create file failure! = Erreur de création du fichier !
Schematics and PCBs can't be imported under My Libs folder, please choose a different folder = Les schémas et les circuits imprimés ne peuvent pas être importés dans le dossier Mes Bibliothèques, veuillez choisir un dossier différent
Libraries to be imported under My Libs folder = Bibliothèques à importer dans le dossier 'Mes Bibliothèques'
Please choose only the libraries needed = Sélectionnez seulement les bibliothèques nécessaires
Maximum import is 200 libs at one time! = Importation sumultanée de 200 bibliothèques au maximum !
You libraries will be found under the My Libs folder = Vos bibliothèques sont dans le dossier 'Mes Bibliothèques'
Add to Library = Ajouter à vos bibliothèques
No items have been checked! = Aucun élément sélectionné !
Nothing was found, please create it for yourself = Rien trouvé, veuillez le créez pour vous même
Search result = Résultat de la recherche
At least 3 characters needed = Au moins 3 caractères sont requis
Add to my Favorite Parts = Ajouter à mes 'Composants Favoris'
Added it OK. Please find it in your Favorite Parts = Ajout réussi dans le dossier 'Composants Favoris'
Please select its parent node = Sélectionnez le nœud supérieur
Libraries can not be exported as active project pdf. = Les librairies ne peuvent être exportées en pdf.
Error:No GND = Erreur:Pas de GND
This circuit does not have GND. Please select GND from the circuit tool to add to the circuit. = Ce circuit n'a pas de GND. Veuillez sélectionner GND dans l'outil de circuit à ajouter au circuit.
Current circuit doesn't has Voltage Resource or Current Resource symbol, please place it first at left side EElib or Spice Library. = Le circuit actuel n'a pas de symbole de ressource de tension ou de courant, veuillez d'abord le placer sur le côté gauche de EElib ou de la bibliothèque Spice.
Probe can not connect with ground(GND)! = La sonde ne peut pas se connecter à la masse (GND) !
Spice symbols's attributes can't be empty. = Les attributs des symboles Spice ne peuvent être vide.
Error:No Spice Symbol = Erreur:Pas de symbole Spice
Simulation limit = Limite de simulation
There is a multimeter in the circuit that needs to be simulated using the emulation command .tran or .op = Il y a un multimètre dans le circuit qui doit être simulé à l'aide de la commande d'émulation .tran ou .op
An oscilloscope exists in the circuit and needs to be simulated using the simulation command .tran = Un oscilloscope existe dans le circuit et doit être simulé à l'aide de la commande de simulation .tran
There are components in this circuit that do not have a simulation model. Please use the base library component of the simulation mode for simulation. = Il y a des composants dans ce circuit qui n'ont pas de modèle de simulation. Veuillez utiliser le composant de base de bibliothèque du mode simulation pour la simulation.
Circuit does not have a probe = Le circuit n'a pas de sonde
Make sure your pin numbers are even numbers = Vérifiez que le nombre de broches soit pair
Duplicate Components Prefix = Préfixe de composants en double
All components are hidden successfully! = Tous les composants sont cachés avec succès !
All ratlines are hidden successfully! = Tous les chevelus ont été cachés avec succès !
Hidden the ratline of net {netName} successfully! = Le chevelu de l'interconnexion {netName} a été caché avec succès !
Duplicate Component Prefix = Préfixe de composant en double
{0} exist = {0} existe
There are some invalid packages, are you sure? = Il y a des boitiers non valides, êtes-vous sûr ?
Invalid Characters, library only allows [0-9a-zA-Z-_]
Annotation success = Annotation réussie
If you accept this annotation operation, please save your files. If not, close your files without saving. = Si vous confirmez cette opération, veuillez enregistrer vos fichiers. Sinon, ils seront fermés sans enregistrement.
This file can't be saved under libs project. Please choose other project or create a new project = Ce fichier ne peut pas être enregistré sous le projet libs. Veuillez choisir un autre projet ou créer un nouveau projet
Your file is unsaved. = Votre fichier n'est pas enregistré
You can close the editor now. Have a good day! = Vous pouvez maintenant fermer l'éditeur. Bonne journée !
Successfully logged out = Déconnexion réussie
You have at least one unsaved file open. Please save it or close it. = Vous avez au moins un fichier non enregistré d'ouvert. Veuillez l'enregistrer ou le fermer.
Please select a reference point = Veuillez sélectionner un point de référence
Please save your file before this operation = Veuillez enregistrer votre fichier avant cette opération
Please open a PCB document = Veuillez ouvrir un document de circuit imprimé
Please save your file before '{0}'. = Veuillez enregistrer votre fichier avant '{0}'.
Please try again after saving this file. = Réessayez après avoir enregistré ce fichier.
This text can not be empty! = Ce texte ne peut pas être vide !
Export to Altium fail, please try again or contact us. = Échec de l'exportation vers Altium, veuillez réessayer ou contactez-nous.
Connecting to server = Connexion au serveur en cours
Please login before asking for help = Veuillez vous connecter avant de demander de l'aide
This file has been modified, please save it first! = Ce fichier a été modifié, veuillez d'abord l'enregistrer !
Remove this param = Supprimer ce paramètre
You cannot drag a part to the canvas, please click the part and move the cursor to the canvas and then right-click to place. = Vous ne pouvez pas faire glisser un objet sur le canevas, veuillez cliquer sur l'objet et déplacer le curseur sur le canevas, puis cliquer avec le bouton droit pour le placer.
Undo/Redo temporary error = Erreur temporaire d'annuler/rétablir
We are sorry but there is an unpredictable error in the undo/redo process. This problem will be fixed soon but in the meanwhile it is safe to continue working on your design. = Nous sommes désolés mais il y a une erreur imprévisible dans le processus d'annulation/rétablissement. Ce problème sera bientôt résolu, mais en attendant, vous pouvez continuer à travailler sur votre conception en toute sécurité.
The schematic has duplicate prefixes of the components, please make them unique. You can check them using the Design Manager. = Le schéma a des préfixes de composant en double, veuillez les rendre uniques. Vous pouvez les vérifier à l'aide du gestionnaire de conception.
Found duplicated prefix components, can not Import Changes, please modify the duplicated prefix or delete related component. = Doublons de préfixes de composants trouvés, impossible d'importer les modifications, veuillez modifier le préfixe dupliqué ou supprimer le composant associé.
Please click the below help button to find out how to fix this problem. = Veuillez cliquer sur le bouton d'aide ci-dessous pour savoir comment résoudre ce problème.
Please create a board outline! Click the help button to find out how to create a board outline. = Veuillez créer un contour de carte ! Cliquez sur le bouton d'aide pour découvrir comment créer un contour de carte.
Can not fetch files from server, please check your network and try again = Impossible de récupérer les fichiers du serveur, veuillez vérifier votre réseau et réessayer
Please open a schematic first! = Veuillez d'abord ouvrir un schéma !
Can not find the schematic of this PCB = Ne peut pas trouver le schéma de ce circuit imprimé
invalid points! = Points invalides !
This file does not support this operation. = Ce fichier ne prend pas en charge cette opération.
Net Name Conflict = Conflit de nom d'interconnexion
Net name = nom d'interconnexion
{0} are in the same wire, please remove others and just keep one. = {0} sont sur le même fil, veuillez supprimer les autres et n'en garder qu'un.
This field can't be removed! = Ce champ ne peut pas être supprimé !
Annular ring of the pad/via is too small = La bague annulaire de la pastille/via est trop petite
The size of the hole cannot exceed the size of the pad = La taille du trou ne peut pas dépasser la taille de la pastille
Are you sure you want to create a multi-sheet designs? = Êtes-vous sûr de vouloir créer des conceptions muti-feuilles ?
Are you sure you want to create a {0}multi-sheet designs{1}? = Êtes-vous sûr de vouloir créer des {0}conceptions muti-feuilles{1} ?
Please build the copper area! Click the help button to find out how to build the copper area. = S'il vous plaît, construisez la zone de cuivre! Cliquez sur le bouton d'aide pour savoir comment construire la zone de cuivre.
Suggest to set a package for this component first! = Suggérez de définir d'abord un boîtier pour ce composant !
Please select an opened document first. = Veuillez d'abord sélectionner un document ouvert.
Some files failed to load. Please reload the page. = Certains fichiers n'ont pas pu être chargés. Veuillez recharger la page.

#UI Intro
Skip = Sauter
« Back = « Précédent
Next » = Suivant »
Done = Terminé
This is the user management menu. = Il s'agit du menu de gestion des utilisateurs.
This is the toolbar. = C'est la barre d'outils.
This is the navigation list. Under here you can find projects, files, parts and libraries. = Il s'agit de la liste de navigation. Ci-dessous, vous pouvez trouver des projets, des fichiers, des pièces et des bibliothèques.
Show or hide the toolbar to the top of the window here. = Affichez ou masquez la barre d'outils en haut de la fenêtre ici.
Show, resize or hide the left sidebar to the left of the window here. = Affichez, redimensionnez ou masquez la barre latérale gauche à gauche de la fenêtre ici.
Show or hide the right sidebar to the right of the window here. = Affichez ou masquez la barre latérale droite à droite de la fenêtre ici.

#Standard libs
Passive Components = Composants passifs
Power Supply = Alimentation
Diodes = Diodes
Regulator = Régulateur
Transistor = Transistor
Transformers = Tranformateurs
Gates = Portes logiques
Vacuum Tubes = Tubes électroniques
Switch = Interrupteur
Relay = Relais
Capacitor(US) = Condensateu (US)
Capacitor(EU) = Condensateur (EU)
Capacitor(EU)2 = Condensateur (EU)2
Electrolytic Capacitor(US) = Condensateur électrolytique (US)
Electrolytic Capacitor(EU) = Condensateur électrolytique (EU)
Electrolytic Capacitor(US)2 = Condensateur électrolytique (US)2
Electrolytic Capacitor(EU)2 = Condensateur électrolytique (EU)2
Inductor(US) = Inductance (US)
Inductor(EU) = Inductance (EU)
Potentiometer_US = Potentiomètre_US
Potentiometer_EU/IEC = Potentiomètre_EU/IEC
Potentiometer_3D = Potentiomètre_3D
Resistor(US) = Résistance (US)
Resistor(EU) = Résistance (EU)
Resistor 45 Deg(US) = Résistance 45 degrés (US)
Resistor 45 Deg(EU) = Résistance 45 degrés (EU)
Variable Capacitor(US) = Condensateur variable (US)
Variable Capacitor(EU) = Condensateur variable (EU)
Variable Resistor(US) = Résistance variable (US)
Variable Resistor(EU) = Résistance variable (EU)
Variable Inductor(US) = Inductance variable (US)
Variable Inductor(EU) = Inductance variable (EU)
Varistor = Varistance
Inductor2(US) = Inductance (US)2
Inductor2(EU) = Inductance (US)2
Battery = Batterie/Accumulateur
Voltage Source = Sources de tension
Current Source = Sources de courant
CCCS(Current Controlled Current Source) = Source de courant commandée en courant
CCCS2(Current Controlled Current Source) = Source de courant commandée en courant-2
VCCS(Voltage Controlled Current Source) = Source de courant commandée en tension
VCVS(Voltage Controlled Voltage Source) = Source de tension commandée en tension
CCVS(Current Controlled Voltage Source) = Source de tension commandée en courant
CCVS2(Current Controlled Voltage Source) = Source de tension commandée en courant-2

BV(Behavioral Voltage Sources) = Sources de tension programmables
BI(Behavioral Voltage Sources) = Sources de courant programmables
Epoly(Non-linear Voltage Source) = Sources de tension non-linéaires
Gpoly(Non-linear Current Source) = Sources de courant non-linéaires

Diode = Diode
LED = DEL
LED_3D = DEL_3D
Schottky Diode = Diode Schottky
Varactor Diode = Diode Varactance
Zener = Diode Zener
Unidirectional TVS Diode = Diode TVS uni-directionnelle
Bidirectional TVS Diode = Diode TVS bi-directionnelle
Diac = Diac
Bridge = Pont
78XX = 78XX
79XX = 79XX
LM317 = LM317
LM337 = LM337
TL431 = TL431
BJT(NPN) = Transistor bipolaire (NPN)
BJT(PNP) = Transistor bipolaire (PNP)
MOSFET(Nch) = MOSFET (canal N)
MOSFET(Nch) Depletion Four-pins = MOSFET canal N à déplétion (4 broches)
MOSFET(Nch) Enhancement = MOSFET canal N à enrichissement
MOSFET(Nch) Enhancement Four-pins = MOSFET canal N à enrichissement (4 broches)
MOSFET(Pch) = MOSFET (canal P)
MOSFET(Pch) Depletion Four-pins = MOSFET canal P à déplétion (4 broches)
MOSFET(Pch) Enhancement = MOSFET canal P à enrichissement
MOSFET(Pch) Enhancement Four-pins = MOSFET canal P à enrichissement (4 broches)
JFET(Nch) = Transistor à effet de champ (JFET) Canal N
JFET(Pch) = Transistor à effet de champ (JFET) Canal P
Darlington NPN = Darlington NPN
Darlington PNP = Darlington PNP
MESFET(Nch) = MESFET (canal N)
MESFET(Pch) = MESFET (canal P)

IGBT = IGBT
SCR = Thyristor
Triac = Triac
Transform(US) = Tranformateur (US)
Transform(EU) = Tranformateur (EU)
Transfrom(NEUTRAL-CTR TAP)(US) = Tranformateur avec point milieu (US)
Transfrom(NEUTRAL-CTR TAP)(EU) = Tranformateur avec point milieu (EU)
Mutual Inductors = Inductance mutuelle
Mutual Inductors2 = Inductance mutuelle-2
Or Gate = Porte OU
Xor Gate = Porte OU exclusif
And Gate = Porte ET
Nor Gate = Porte NON-OU
Nand Gate = Porte NON-ET
Not Gate = Porte NON
Xnor Gate = Porte NON-OU exclusif
Tube Diode = Tube Diode
Tube Triode = Tube Triode
Tube Tetrode = Tube Tetrode
Tube Pentode = Tube Pentode
Voltage Controlled Switch = Interrupteur commandé en tension
Current Controlled Switch = Interrupteur commandé en courant
SPST ON = Contact Fermé
SPST OFF = Contact Ouvert
Fuse = Fusible
555 = NE555
555(Style2) = NE555-2
Speaker = Haut-parleur
XTAL = Quartz
5pin Operational Amplifier = AIL 5 broches
3pin Operational amplifier = AIL 3 broches
Transmission Line = Ligne de transmission
Voltmeter = Voltmètre
Ammeter = Ampèremètre
LAMP = Lampe
Opto Transistor = Opto-Transistor

#Server Message
Need login = Vous devez vous identifier
Bad password = Erreur de mot de passe
We can't find your username or your email, please check it! = Nous ne trouvons pas votre nom d'utilisateur ou votre e-mail, veuillez le vérifier !
Make sure your uploaded file size is less than 3MB! = Assurez-vous que la taille de votre fichier téléchargé est inférieure à 3 Mo !
Bad file type = Mauvais type de fichier
Empty file or bad file type, ensure your file is Eagle 6.0+ = Fichier vide ou type de fichier incorrect, assurez-vous que la version d'Eagle est supérieure ou égale à 6.0
This operation not supported on demo account = Cette opération n'est pas prise en charge sur un compte de démonstration
Can not share this file under a private project, please set the active project to public! = Impossible de partager ce fichier dans le cadre d'un projet privé, veuillez définir le projet actif sur public !
Login Failed Too many attempts. If you forgot your password, please {0}reset your password{1} or send an email to support@easyeda.com = Échec de la connexion. Trop d'essais. Si vous avez oublié votre mot de passe, veuillez {0}réinitialiser votre mot de passe{1} ou envoyez un e-mail à support@easyeda.com

#Dialog Common Buttons
Common Buttons Setting = Réglage des boutons communs
Menu Setting... = Réglage du menu...
Show/Hide = Monter/Cacher
Move Up = Monter
Move Down = Descendre
Reset All = Réinitialiser tout
Zoom = Zoom
Place Pin = Placer une broche

#System Setting Dialog
System = Système
Zoom Mode = Mode de zoom
Scroll Key = Touche de défilement
CTRL + Scroll = CTRL + défilement
Canvas Coordinate System = Système de coordonnées du canevas
SVG Coordinate = Coordonées SVG
Cartesian Coordinate = Coordonnées cartésiennes
Open Wizard Dialog for New Schematic = Ouvrir la boîte de dialogue de l'assistant pour un nouveau schéma
Default Unit = Unité par défaut
Canvas Zoom Effect = Effet de zoom sur le canevas
Quality Priority = Priorité à la qualité
Speed Priority = Priorité à la vitesse
Rotation Step = Pas de rotation
Add Teardrop Automatically = Ajouter une larme automatiquement
Assign Net for Free Track/Arc/Circle = Attribuer une interconnexion pour une piste/un arc/un cercle libre
Open Wizard Dialog for New PCB = Ouvrir la boîte de dialogue de l'assistant pour un nouveau circuit imprimé
Rebuild Plane Automatically = Reconstruire le plan automatiquement
The Track's Routing Follows Component's Rotation = Le routage de la piste suit la rotation du composant
Display Pad's Number and Net = Affiche le numéro de la pastille et l'interconnexion
Favorite Track width = Largeur de piste préférée
Track Width Setting = Réglage de la largeur de piste


#Dialog Access Control
Permissions = Autorisations
Operation = Opération
Access Control = Contrôle d'accès
Project Access Control = Contrôle d'accès au projet
Reject = Rejeter
Add User = Ajouter un utilisateur
Bad email address = Adresse e-mail invalide
#后端返回英文的错误信息
Can't find this email address in EasyEDA. Your partner must be an EasyEDA user. = Impossible de trouver cette adresse e-mail dans EasyEDA. Votre partenaire doit être un utilisateur EasyEDA.

#Dialog waveForm
Grid Background = Arrière plan de la grille
Pane Background = Arrière plan du panneau
WaveForm Config = Configuration de forme d'onde
Export Waveform = Exporter la forme d'onde


#attr-canvas-grid-style
dot = point
line = ligne

#attr-canvas-frame-size
Other = Autre
A4 Portrait = A4 portrait
A4 Landscape = A4 paysage
A3 Portrait = A3 portrait
A3 Landscape = A3 paysage
A2 Portrait = A2 portrait
A2 Landscape = A2 paysage
A1 Portrait = A1 portrait
A1 Landscape = A1 paysage
Landscape = paysage
Portrait = portrait

#Stroke Style
solid = continu
dashed = tirets
dotted = pointillé

#Solid Region
Solid Region = région pleine
Type = Type
type = type

#Dialog Libs Management
Report error = Signaler une erreur
Please give us some information to help us find the problem. = Veuillez nous donner quelques informations pour nous aider à trouver le problème.
Cannot place parts into this document: Schematic Symbols can only be placed into a Schematic; PCB Footprints can only be placed into a PCB. = Impossible de placer des pièces dans ce document : les symboles ne peuvent être placés que dans un schéma ; Les empreintes ne peuvent être placées que dans un circuit imprimé.
Save it as a favorite part = Enregistrez-le en tant que composant préféré
Only logged-in users can save this component as a Favorite Part but guest (Anonymous) users can place this component into their design directly. Would you like to place this component now? = Seuls les utilisateurs connectés peuvent enregistrer ce composant en tant que composant préféré, mais les utilisateurs invités (anonymes) peuvent placer ce composant directement dans leur conception. Souhaitez-vous placer ce composant maintenant ?

#Others
Find libs = Trouver une bibliothèque
My Projects = Mes projets
My Parts = Mes composants
My Modules = Mes modules
Assembly LCSC Components = Composants assemblés LCSC
Modules = Modules
SCH Module = Modules pour schéma
PCB Module = Modules pour circuit intégré
System IC = Circuits Système
LCSC (Official) = LCSC (Officiel)
LCSC Electronics = 
Simple Mode = Mode simple
Expand Mode = Mode étendu
Help Verify = Aider à vérifier
Favorite Parts = Composants favoris
Shared With Me = Partagé avec moi
Preview = Apperçu
Preview Window = Fenêtre d'apperçu
System Default = Défini par le système
User Defined = Défini par l'utilisateur
Theme = Thème
Theme Setting = Réglage du thème
Close = Fermer
Open = Ouvrir
Collapse = Replier
Toggle toolbar = Basculer la barre d'outils
Toggle left bar = Basculer barre de gauche
Toggle right bar = Basculer barre de droite
Reload = Recharger
Mouse-X = Souris X
Mouse-Y = Souris Y
Mouse-DX = Souris DX
Mouse-DY = Souris DY
Bus entry x1 = Entrée de bus x1
Bus entry x2 = Entrée de bus x2
Bus entry y1 = Entrée de bus y1
Bus entry y2 = Entrée de bus y2
Yes = Oui
No = Non
OK = OK
Confirm = Confirmer
Continue = Continuer
Cancel = Annuler
Update = Mettre à jour
Bus entry = Entrée de bus
Filter = Filtre
Check = Vérifier
Guest Project = Projet invité
Insert into = Insérer dans
Insert into {site} = Insérer dans {site}
# Upload {site} 目前仅有波兰论坛使用
Upload {site} = Téléverser {site}
Copy the contents of this box into a text editor, then save the file. Paste the edited text back into this box and click Apply to update the display. = Copiez le contenu de cette boîte dans un éditeur de texte, puis enregistrez le fichier. Collez le texte modifié dans cette zone et cliquez sur Appliquer pour mettre à jour l'affichage.
Copy the contents of this box into a text editor, then save the file with a .svg extension. You can edit it in Inkscape or open it in your browser. = Copier le contenu de cette fenêtre dans le Bloc-notes et enregistrer le fichier avec une extension SVG. Vous pouvez alors le modifier avec Inkscape ou l'ouvrir dans un navigateur.
Content is too big to show, you can download it directly. = Le contenu est trop volumineux pour être affiché, vous pouvez le télécharger directement.
SVG format = Format SVG
SVG File = Fichier SVG
Description should be no more than 250 letters = La descripton ne doit pas dépasser 250 caractères
The file save operation has timed out. Try again and check your Internet connection. = Durée d'enregistrement dépassée. Vérifiez votre connexion Internet et réessayez à nouveau.
Export Netlist = Exporter la netListe
Notifications = notifications
Please select txt or json files. = Veuillez sélectionner des fichiers txt ou json.
Failed to read file [{file}]
[{file}] is not a valid json file
Invalid parameters! = Paramètres invalides !
Download = Téléchargement
Start = Début
You have unsaved files, are you sure you want to log out without saving the files? = Vous avez des fichiers non enregistrés, êtes-vous sûr de vouloir vous déconnecter sans enregistrer les fichiers ?
Please use the web version to run this function. = Veuillez utiliser la version Web pour exécuter cette fonction.
Please save this file to you project! = Veuillez enregistrer ce fichier dans votre projet !
Nothing changed = Rien n'a changé
Delete Node = Supprimer un nœud
This layer is invisible. = Cette couche est invisible.
When the solid region is Board Cutout, please set the layer to Multi-Layer. = Lorsque la zone pleine est une découpe de carte, veuillez définir la couche sur Multi-Couche.
You should not try to assign a net to a Board Cutout solid region. = Vous ne devez pas essayer d'attribuer une interconnexion à une région pleine de découpe de carte.
Net Length = Longueur de l'interconnexion
You can place a Pin in the schematic, but don't forget to group all of the Pins to a schematic component. Please click the help button to find out how to group them. If you just want to mark the wire, please use NetPort or NetLabel. = Vous pouvez placer une broche dans le schéma, mais n'oubliez pas de regrouper toutes les broches dans un composant du schéma. Veuillez cliquer sur le bouton d'aide pour savoir comment les regrouper. Si vous souhaitez simplement marquer le fil, veuillez utiliser NetPort ou NetLabel.
Please input the modification = Veuillez saisir la modification
The content must be between {0} and {1} characters = Le contenu doit comporter entre {0} et {1} caractères

Coming soon = Bientôt disponible
No tool = Aucun outil
Help us translate into your language = Aidez nous à traduire dans votre langue
Pad = Pastille
Via/Hole = Via/Trou
PCB Layers = Couches du circuit imprimé
Order PCB = Commander un circuit imprimé
Share = Partager
Free = Gratuit
Small = Petit
Medium = Moyen
Big = Grand


Embed = Embarqué
HTML = HTML
URL = URL
BBCode = BBCode
PNG = PNG
Exporting as = Exporter comme
Exporting as image = Exporter comme image
Exporting as {0}SVG{1} file. = Exporter fichier {0}SVG{1}.
Exporting as pdf is recommended: pdf gives good quality printed output and a small file size. = Exportation en pdf recommandée : le pdf est de petite taille et permet une bonne qualité d'impression.
Generate PCB Fabrication File(Gerber) = Générer un fichier de fabrication de circuit imprimé (Gerber)
PenWidth-Increase = 

#Generate Gerber
Generate Gerber = Générer un Gerber
Gerber View = Voir un Gerber
Dimensions(Estimated) = Dimensions(estimées)
PCB Qty = Nombre de circuits imprimés
Copper Weight = Épaisseur de cuivre
PCB Price = Prix du circuit imprimé
Estimated Delivery Time = Temps de livraison estimé
For your first time order, less than $20 discount on the freight! = Pour votre première commande, moins de 20$ de rabais sur le transport !
HASL(with lead) = HASL(avec plomb)
LeadFree HASL-RoHS = Sans plomb HASL-RoHS
ENIG-RoHS = 
Would you like to do Design Rule Checking (DRC) before generating the Gerber files? = Souhaitez-vous effectuer une vérification des règles de conception (DRC) avant de générer les fichiers Gerber ?
Yes, Check DRC = Oui, vérifier les règles de conception
No, Generate Gerber = Non, générer le Gerber
This PCB has uncompleted connection(s), do you want to check the connection(s)? = Ce PCB a une ou plusieurs connexions inachevées, voulez-vous vérifier la ou les connexion(s) ?
Yes, Check Connection(s) = Oui, vérifier les connexions
It will then redirect to the web site of a thirdparty JLCPCB with which we cooperate. Are you ready? = Il sera alors redirigé vers le site Web d'un tiers de JLCPCB avec lequel nous coopérons. Êtes-vous prêt?
Failed to submit your order, please contact us via support@easyeda.com for help. = Échec de la soumission de votre commande, veuillez nous contacter via support@easyeda.com pour obtenir de l'aide.
Failed to submit your order, please contact us via QQ 800821856. = Échec de la soumission de votre commande, veuillez nous contacter via QQ 800821856.
Order data generated finish, please click OK button and continue. = Génération de la commande terminée, veuillez cliquer sur le bouton OK pour continuer.
[generateGerber]
Layers = Couches
[/generateGerber]

[version]
Switch = Basculer
[/version]


Export your file, then print it yourself. = Exporter le fichier puis imprimez-le vous-même.
Trace width is too small = Piste trop étroite
Share = Partager

Images Attribute = Attibuts de l'image
Connect Pad to Pad = Connecter pastille à pastille
Copper Area = Zone de cuivre
Dimension = Dimension


Please check that you have used Wire and not Line to connect electrical elements. = Veuillez vérifier que vous avez utilisé le fil et non la ligne pour connecter les éléments électriques.
PCB Fabrication Prices & capabilities = Prix de fabrication du circuit et possibilités 
Flip all texts on bottom layer = Retourner tous les textes sur la couche inférieure
Create New Document = Créer un nouveau document
General Package = Boîtier génériques
General Packages = Boîtiers génériques
favorite Package = Boîtier favori
Board Cutout = Découpe de carte
Surface Mount = Monté en surface
JLCPCB Part Class = Classe de composant JLCPCB
base = base
expand = étendu
recommend = recommandé
Basic Part = Composant de base
Extended Part = Composant étendu
Recommended Part = Composant recommandé
smtWeld = 
thtWeld = 
manualWeld = 
furnaceWeld = 
Multi-Layer = Multi-couche
Markdown Syntax = Syntaxe Markdown
Markdown supported = Markdown pris en charge
Read only = Lecture seule
Read/Write = Lecture/écriture
More Libraries... = Plus de bibliothèques...
Decompress failed! = Échec de la décompression !
Load failed! = Échec du chargement !
Loading = Chargement
No Result = Pas de résultat

#Dialog Place Pin in schematic warning
Place Pin in schematic warning = Avertissement de positionnement de broche dans le schéma
You can place a Pin in schematic, but don't forget to group all of the Pins to a schematic component, please click the help button to find out how to group them. If you just want to mark the wire, please use NetPort or NetNabel. = Vous pouvez placer une broche dans le schéma, mais n'oubliez pas de regrouper toutes les broches dans un composant du schéma, veuillez cliquer sur le bouton d'aide pour savoir comment les regrouper. Si vous souhaitez simplement marquer le fil, veuillez utiliser NetPort ou NetNabel.
I know. Do not show this again. = Je sais. Ne me montre plus ça.

#Extensions Setting
Extensions Setting = Réglage des extensions
Remove = Supprimer
Disable = Désactiver
Enable = Avtiver
(Disabled) = (Désactivé)
(Enabled) = (Avtivé)
Load Extension = Charger l'extension
Enable or disable will be applied after reload page = Activer ou désactiver sera appliqué après le rechargement de la page
Your browser cannot run this function. = Votre navigateur ne peut pas exécuter cette fonction.
Your browser mode does not support indexedDB. Some features may not work properly. Are you using Private Browsing Mode? = Votre mode de navigateur ne prend pas en charge indexedDB. Certaines fonctionnalités peuvent ne pas fonctionner correctement. Utilisez-vous le mode de navigation privée ?
Extension Files = Fichiers d'extension
Extension ID = Identifiant de l'extension
Select Files = Sélectionnez les fichiers

#Scripts
Script = Script
Scripts = Scripts
Script Content = Contenu du script
Load from js file = Charger depuis un fichier js
UTF-8 encoded js file = Fichier js encodé en UTF-8
Description = Description
description = description
Not a *.js file = N'est pas un fichier *.js
Failed to read file = Échec de la lecture du fichier
System scripts cannot be modified = Les scripts système ne peuvent pas être modifiés
Create Subfolder = Créer un sous-dossier
Create Script = Créer un script
Install Script = Installer un script
Install = Installer
Are you sure you want to remove this script? = Voulez-vous vraiment supprimer ce script ?
Folder Name = Nom du dossier
Rename = Renommer
Please select a script = Veuillez choisir un script
Failed to load script = Échec du chargement du script
Run Script = Exécuter le script
Load Script = Charger un script
Title is required = Le titre est requis
Script content is required = Le contenu du script est requis
System Scripts = Scripts système
User Scripts = Scripts utilisateur
You can right click on the tree nodes. = Vous pouvez faire un clic droit sur les nœuds de l'arbre.

#PCB photoView toolbar
Top Side = Côté supérieur
Bottom Side = Côté inférieur
With Silk Layer = Avec sérigraphie
No Silk Layer = Sans sérigraphie
Photo View = Vue photo

#check update
Check Update = Vérifier la mise à jour
EasyEDA Editor {ver} is released. Would you like to switch to the new version now? = L'éditeur EasyEDA {ver} est disponible. Souhaitez-vous passer à la nouvelle version maintenant ?
LCEDA Editor {ver} is released. Would you like to switch to the new version now? = L'éditeur LCEDA {ver} est disponible. Souhaitez-vous passer à la nouvelle version maintenant ?
Switch to New Version = Basculer vers la nouvelle version
Next Time = Prochaine fois

#download project dialog
Generating download link... = Générer un lien de téléchargement...
Download project now = Télécharger le projet maintenant

#Import DXF
Import DXF = Importer un DXF
Apply Unit = Appliquer l'unité
Convert circle to HOLE on BoardOutLine layer = Convertir le cercle en TROU sur la couche ContourDeCarte
No shapes found = Pas de forme trouvée
Fail to load the file = Échec du chargement du fichier
Please select a DXF file. = Veuillez choisir un fichier DXF
This feature only works for PCB document. = Cette fonctionnalité ne fonctionne que pour les documents de circuit imprimé.
Select a DXF file = Choississez un fichier DXF

#Export DXF
Export DXF = Exporter un DXF
Plated-Through-Hole Pads = Pastilles à trous métalisés
Non-Plated-Through-Hole Pads = Pastilles traversantes non métalisée
Silkscreen = Sérigraphie
Surface Pad = Pastille de surface

#Data Sync
Data Sync = Synchro des données
Data Conflicts = Conflits de données
Project or Document = Projet ou document
Cloud-Side = Sur le Cloud
Local-Side = En local
Decision = Décision
Modified = Modifié
Deleted = Supprimé
As Cloud = Comme sur le Cloud
As Local = Comme en local
Skip = Sauter
Data sync completed = Synchronisation des données terminée

#Team
Team = Équipe
Teams = Équipes
Switching team = Changer d'équipe
Switch team failed = Échec du changement d'équipe
Load team info fail! = Échec du chargement des informations de l'équipe !
Load team info fail! Please reload. = Échec du chargement des informations de l'équipe ! Veuillez recharger.
My Teams = Mes équipes
Create Team = Créer une équipe

#Dialog Footprint Manager
Footprint Manager = Gestionnaire d'empreinte
Open Footprint Manager = Ouvrir le gestionnaire d'empreinte
Schematic Components = Composants du schéma
Edit Pin Map Information = Modifier les informations de disposition des broches
Package Categories = Catégories de boîtiers
Components List = Liste de composants
Personal = Personnel
Component PIN information = Information sur la broche du composant
Footprint PAD information = Information sur la pastille de l'empreinte
Footprint Categories = Catégories d'empreintes
Pad Number = Numéro de pastille
Search Footprint = Rechercher une empreinte
Filter by keyword = Filtrer par mot-clé
System Libs = Bibliothèques système

#dialog global delete
Drawings = Dessins
Netlabel and netFlag = Étiquette et drapeau d'interconnexion
Texts = Textes
Wires = Fils
Board outlines = Contours de carte
Footprints = Empreintes
Footprint = Empreinte
Tracks = Pistes

#dialog board outline settings
Current Size = Taille actuelle
Paramenters = Paramètres
Start X: = Début X :
Start Y: = Début Y :
Round Rectangular = Rectangle arrondi
radius = rayon
only number is allowed! = seul un nombre est autorisé !
please input valid value of width! = veuillez saisir une valeur valide pour la largeur !
please input valid value of height! = veuillez saisir une valeur valide pour la hauteur !
please input valid value of radius! = veuillez saisir une valeur valide pour le rayon !

#cross probe
The object you selected was not found in other documents. = L'objet que vous avez sélectionné n'a pas été trouvé dans d'autres documents.
No valid object for cross probe selected. = Aucun objet valide pour la sonde croisée sélectionné.
Can not probe. Refreshing the window may get it to work. = Impossible de sonder. Rafraîchir la fenêtre peut la faire fonctionner.
You need to login for this function to work. = Vous devez vous connecter pour que cette fonction fonctionne.

#About Dialog
An Easier EDA Experience = Une expérience EDA plus facile
Version = Version
BuiltDate = Date de compilation

#Auto Router Dialog
Auto Router Config = Configuration de l'auto-routeur
General Options = Options générales
All Layers = Toutes les couches
Configure = Configurer
Sorry, your web browser does not support this feature. Please run a modern browser. = Désolé, votre navigateur Web ne prend pas en charge cette fonctionnalité. Veuillez exécuter un navigateur moderne.
Please make sure all objects with net are inside the board outline! = Veuillez vous assurer que tous les objets avec interconnexion sont à l'intérieur du contour du carte !
Cannot start again before previous activity is stopped = Impossible de recommencer avant l'arrêt de l'activité précédente
Please select a net = Veuillez choisir une interconnexion
TrackWidth cannot be empty = La largeur de piste ne peut être vide
Clearance cannot be empty = Le dégagement ne peut pas être vide
Router is time out. = Le routeur a dépassé le délai.
Server is busy, please try again later. = Le serveur est occupé, veuillez réessayer plus tard.
Due to the limitation of {0}router server{1} resources, multiple routers executing concurrently are not supported, please try again later or do it manually :-) = En raison de la limitation des ressources du {0}serveur de routage{1}, plusieurs routages s'exécutant simultanément ne sont pas pris en charge, veuillez réessayer plus tard ou le faire manuellement :-)
Track Width is invalid = Largeur de piste invalide
General Clearance is invalid = Le dégagement générique est invalide
SMD Clearance is invalid = Le dégagement CMS est invalide
Diameter is invalid = Diamètre invalide
Drill Diameter is invalid = Le diamètre de perçage n'est pas valide
Track width cannot be less than Design Rule Checking (DRC) setting value. = La largeur de piste ne peut pas être inférieure à la valeur du paramètre des règles de conceptions (DRC).
General Clearance cannot be less than Design Rule Checking (DRC) setting value. = Le dégagement générique ne peut pas être inférieure à la valeur du paramètre des règles de conceptions (DRC).
SMD Clearance cannot be less than Design Rule Checking (DRC) setting value. = Le dégagement CMS ne peut pas être inférieure à la valeur du paramètre des règles de conceptions (DRC).
Hole size cannot be less than Design Rule Checking (DRC) setting value. = La taille du trou ne peut pas être inférieure à la valeur du paramètre des règles de conceptions (DRC).
Design Rule's via diameter must larger than via drill diameter = Le diamètre du via de la règle de conception doit être plus grand que le diamètre de perçage du via
Clearance cannot be less than Design Rule Checking (DRC) setting value. = Le dégagement ne peut pas être inférieure à la valeur du paramètre des règles de conceptions (DRC).
Not a valid PCB, please check it again = N'est pas un circuit imprimé valide, veuillez vérifier de nouveau
Previous connection must be closed = La connexion précédente doit être fermée
Network error. Please try again. = Erreur réseau. Veuillez réessayer.
Router error. = Erreur du routeur
Invalid PCB. = Circuit imprimé invalide.
General Clearance = Dégagement générique
SMD Clearance = Dégagement CMS
#Ripup Nets
Skip Routed Nets = Sauter les interconnexion routées
Remove Existing Tracks = Supprimer les pistes existantes
Real-time Display = Affichage temps-réel
Router Layers = Couches du routeur
Via = Via
Special = Spécial
Special Nets = Interconnexion spéciales
Skip Nets = Suater les interconnexions
Router Server = Serveur de routage
Local = Local
Cloud = Cloud
Available = Disponible
Unavailable = Indisponible
Checking = Vérification
Install Local Auto Router = Installer l'auto-routeur local
Checking local auto router server... = Vérification du serveur local d'auto-routeur
Stop Router = Arrêter le routeur
Auto Router is running... = L'auto-routeur est en cours d'exécution.

#Left Siderbar
EELib = 
Basic = Basique
Extend = Étendu
Design Manager = Gestionnaire de conception
Library = Bibliothèque
Spice Library = Bibliothèque Spice
Shared = Partagé
LCSC = LCSC
LCSC Parts = Composants LCSC
Supply Flag = Drapeau d'approvisionnement
US = USA
EU/IEC = UE/CEI
US Style = Style US
Resistor = Résistance
Capacitor = Condensateur
Inductor = Inductance
Switch/Key = Interrupteur/Bouton
EU/IEC Style = Style UE/CEI
CN = Chine
Connector = Connecteur
Switch/Relay = Interrupteur/Relai
JLCPCB = JLCPCB
Recycle Bin = Corbeille

#量角器
Font Height = Taille de police
Precision = Précision
Protractor = Rapporteur

#attr-pcbtext-line-width
Only default font family supports to change font width. = Seule la famille de polices par défaut prend en charge la modification de la largeur de police.
Font is missing! You can confirm the dialog and use default font instead or cancel the dialog then upload your font and do it again. = La police est manquante ! Vous pouvez confirmer la boîte de dialogue et utiliser la police par défaut à la place ou annuler la boîte de dialogue, puis télécharger votre police et recommencer.

#Common
Owner = Propriétaire
License = Licence
Part Pins = Broches du composant
Net Pins = Broches des interconnexions
Net Ratlines = Chevelus des interconnexions
Add Parameter = Ajouter un paramètre
Histories record = Enregistrement de l'historique
Create Team = Créer une équipe
Can't find this footprint on the server, please re-associate it. = Impossible de trouver cette empreinte sur le serveur, veuillez la réassocier.
The footprint name associated with the component and the footprint name on the server are inconsistent, please re-associate it. = Le nom d'empreinte associé au composant et le nom d'empreinte sur le serveur sont incohérents, veuillez le réassocier.
The symbol pin number(s) of the component does not match the associated footprint pad number(s), please modify the symbol pin number(s) or re-associate the footprint = Le(s) numéro(s) de broche de symbole du composant ne correspond pas au(x) numéro(s) de pastille(s) de l'empreinte associée, veuillez modifier le(s) numéro(s) de broche de symbole ou ré-associer l'empreinte
No footprint, please associate the footprint first. = Pas d'empreinte, veuillez d'abord associer une empreinte.
Can't find the package = Impossible de trouver le boîtier
The path is for the project URL identify, it is unique (the identity of the project owned by the user cannot be the same) = Le chemin est pour l'URL du projet, il est unique (l'identité du projet appartenant à l'utilisateur ne peut pas être la même)
It's with a letter or a number and can contain only numbers, letters, line-through, underscores, and points. It cannot be modified after saving. = Commence avec une lettre ou un chiffre et ne peut contenir que des chiffres, des lettres, des tirets, des traits de soulignement et des points. Il ne peut pas être modifié après l'enregistrement.
Updating document to new format, please wait......After finishing please save your document with Ctrl + S. = Mise à jour du document vers un nouveau format, veuillez patienter ...... Après avoir terminé, veuillez enregistrer votre document avec Ctrl + S.
Open at current project? = Ouvrir le projet courant ?
Please select a history to recover. = Veuillez sélectionner un historique à récupérer.
Be careful! When you click the "Recover" button, this sheet will be overwritten! = Faites attention ! Lorsque vous cliquez sur le bouton "Récupérer", cette feuille sera écrasée !
Recover = Récupérer
There is no PCB under this project, would you like to create one? = 
Please make sure that the chose Altium Designer files are saved as ASCII files. = 
Export to Altium function is currently in beta: = 
1. Please be sure to read the notice before exporting: = 
Export Altium notice and disclaimer = 
2. Please be sure to check again after export! = 
I have read and agree = 
Export to Altium = 
Please make sure that the chose Eagle files are saved in Eagle v6.0 and above. = 
Please make sure that the Kicad files were compressed as the .zip file. = 
Open Altium Designer file = 
The more information please refer at : = 
Please use Gerber file instead of exporting Altium if you are going to do PCB manufacturing. All PCB factories support the Gerber file. Is it ok to Generate the Gerber file? = 
Yes, Generate Gerber = 
No, Export Altium = 
Open Eagle file = 
Open Kicad file = 
Select file(s) = 
Append to current project? = 
Append = Ajouter
Open as new project = Ouvrir comme nouveau projet
Tip: Press {0}SPACE{1} or {2}R{3} to rotate the placing object or selected object. = 
Hotkeys Setting = Réglage des raccourcis
I know. Don't show this again. = 
Manufacturer Part Number can not be less than 2 characters. = 
This prefix was changed to non-subpart format. = 
Save as New Project = 
Save to Existing Project = 
Sheet Setting = 
Sheet Size = 
Pre = 
pre = 
Invalid Data = Donnée non valide
Others = Autres
You are not authorized to share this project. = Vous n'êtes pas autorisé à partager ce projet.
This project is private: if you continue sharing it will be made public. = Ce projet est privé : si vous continuez à le partager, il sera rendu public.
Modify file info = 
Please input search keyword = 
Sort By = Trier par
Date Created = Date de création
Date Modified = Date de modification
Title = Titre
Ascending = Ascendant
Descending = Descendant
Pin to Top = 
Unpin from Top = 
Expand All = Développer tout
Collapse All = Tout réduire
Your file hasn't been saved, do you want to save it? = Votre fichier n'a pas été enregistré, voulez-vous l'enregistrer ?
Don't Save = Ne pas enregistrer
Library Owner: = Propriétaire de la bibliothèque :
verifyPkg.Value = 
State = 
Please select! = 
Route = 
Import successfully: = 
Import failed: = 
The title length must be between 2~128 characters. = 
Path only contain 'a-z、A-Z、- 、 _ 、0-9'! = 
Path must begin as 'a-z、A-Z、0-9'! = 
The path length must be between 4~128 characters! = 
The title length must be between 2~256 characters! = 
The title can not less than 3 charaters! = 
Do you want to delete this file? = Voulez-vous supprimer ce fichier ?
Add sub part success = 
Please input name and prefix! = 
Board outlines are not closed = 
Import Altium file fail, the file needs to be an ASCII file encoded in UTF-8. = 
The Pins "{0}" are not snapped on the grid point! This part maybe will cause some errors in the schematic. = 
Check Pin = 
Failed to read {0} = 
{0} is invalid = 
{0} not found = 
Failed to execute script: = 
One or more js files not found = 
Only ONE {0} file is required = 
Extension ID is required = 
Extension ID is invalid = 
Extension ID is duplicated = 
No Result! = Pas de résultat!
Load Error = 
loading = 
Failed to load spice data = 
Netlist = 
Tags = 
Pin Information: = 
Format incorrect, please check for the extra spaces or commas! = 
Round Radius = 
Keyword: = Mot-clé
Image = Image
Image copied. = Image copiée.
Copy failed. = Échec de la copie.
Image Attribute = Attribut de l'image
Locked = Verrouillé
Unlock All = Tout déverrouiller
Unlock = Déverrouiller
Lock = Verrouiller
Please input pin name and pin number! = 
Left-Hand Panel = 
Right-Hand Panel = 
Update All = Tout mettre à jour
The pin number(s) can't find the same pad number(s) = 
Designator = 
Replace = Remplacer
Update failed = 
Successfully updated = 
Update failed! = 
Successfully updated! = 
Successfully updated {0} component(s)! = 
Change = 
Check  Footprints = 
Network Error! = 
Find Similar Objects = 
Current Sheet = 
All Sheets = 
Kind = 
Range = 
Net Label/Net Flag/Net Port/Voltage Probe = 
Bezier/Freehand Draw = 
Arc/Pie = 
Objects Attributes = 
Any = Tout
Same = Identique
Different = Différent
Circular = 
Expose Copper = 
"{0}" font is missing. Please add the font to the font family list. = 
Place Component = 
Delete Segment = Supprimer un segment
Angle = Angle
Board Thickness = 
Layer Distance = 
Silk Screen = 
Surface Finish Color = 
Colors = Couleurs
Board Color = 
Board Side = 
Silk Screen = 
Silk Screen Color = 
Display = Affichage

# 阵列分布与阵列克隆
Distribute Array = 
Array Type = 
Matrix Array = 
Circular Array = 
Item Rotation = 
Location = 
Items per Column = Éléments par colonne
Items per Row = Éléments par ligne
# Column Spacing
# Row Spacing
Spacing(Degrees) = 
Start Degree = 
Rotate Item to Match = 
Clockwise = 
Anti-Clockwise = 
Distribute by = 
Column = Colonne
Row = Ligne
Array Clone = 
Number of Rows = Nombre de lignes
Number of Columns = Nombre de colonnes
Number of Copies = Nombre de copies
Distribute Range(Degrees) = 

#主题颜色对话框
BusEntry = 
Foreground = 
Common Used = 
Original Theme = 
Theme Setting = 
Change the theme colors of your design = 
White on Black = 
Black on White = 
Custom Theme = 
Color Setting = 
Apply Setting = Appliquer le paramètre
Theme Setting... = 
Bus Entry = Entrée de bus
Foreground = Premier plan
Symbol Graphics = 
Common Used = 
Draw = 
Sheet = 
The original theme only works for placing the new symbols. = 
Selection Highlight = 
Net Label / Port = 

My Theme = Mon thème
My Theme Settings = 
Apply 'Custom Theme' On = 
Creating New Schematic = 
Opening Existed Schematic = 
Please fill in all parameters! = 
Convert to Board Cutout = 
Prefix Position = 
Name Position = 
Center = Centre
Top = Haut
Bottom = Bas
Left = Gauche
Right = Droite
Does not support multiple objects to convert to Board Cutout at the same time = 
Does not support multiple objects to convert to pad at the same time = 
Convert to Board Cutout = 
Convert to Pad = Convertir en pastille
Convert to Component Shape = 
Combine to Continuous Track = 
Convert to Solid Region = 
Substrate = 
3D View = Vue 3D
2D View = Vue 2D
Pin Color = 
Name Color = 
Number Color = 
Dot = Point

[theme]
Sheet = 
[/theme]


#history dialog
[history-dlg]
Number = Nombre
Editor = Éditeur
[/history-dlg]
View File History = 
Save Time = 

Invalid Format = Format invalide

#Dialog Teardrop
Round Pad / Via = 
Rectangle / Oval / Polygon Pad = 
Applying Teardrops = 
Removing Teardrops = 
Waiting = 
Progressing... = 

No schematic in the project! = Pas de schéma dans le projet!

Move Forward = Avancer
Move Backward = Reculer

#Dialog Panelize
V-CUT = 
Stamp Hole = 
No Panelize = 
Border and Marking = 
Create Border = 
Border Height = 
Border Position = 
Create Positioning Holes = 
Create Fiducial Marks = 
Top and Bottom = 
Left and Right = 
Stamp Hole Group - Column = 
Stamp Hole Group - Row = 
The number of rows and columns cannot be set to 1 simultaneously = 

#edit path point
[editPathPoints-dlg]
Arc(R) = Arc(R)
Type = Type
Action = Action
add before = ajouter avant
add after = ajouter après
delete = supprimer
[/editPathPoints-dlg]

#edit polygon point
[editPolygonPoints-dlg]
Action = Action
add before = ajouter avant
add after = ajouter après
delete = supprimer
[/editPolygonPoints-dlg]
You have unconfirmed edit! = 
Invalid edit! = 

#Dialog PCB Information
PCB Information... = 
Signal Layers = 
None Signal Layers = 
Pads = Pastilles
Surface Pads = 
Plated Through-hole Pads = 
None Plated Through-hole Pads = 
Holes = Trous
Vias = Vias
Length of Tracks = Longueur des pistes
Copper Areas = Zones de cuivre

#Differential Pair Routing
Differential Pair Routing = Routage paire différentielle
Differential Pair Rule Setting = 
Please input track width = 
Please input clearance = 
Routing Rules = Règles de routage

#Route Length Tuning
Track Length Tuning... = 
Tracks with different net or non-track found in current targets. = 
Please select the signal tracks to be tuning. = 
The total length exceeds the Design Rule Checking (DRC) constraint, continue ? = 
45° Angle = Angle à 45°
90° Angle = Angle à 90°
DRC Track Length : = 
Current Length : = Longueur actuelle :
Additional Length : = Longueur supplémentaire
Target Length: = Longueur cible :
Current Length: = Longueur actuelle :

can not connect to the server = 

#Dialog Copper Area Manager
Copper Area Manager... = 
Copper Area Manager = 
Order = Commande
Name = Nom
Layer = Couche
Color = Couleur
Net = Connexion
Move Up = Monter
Move Down = Descendre
Apply = Appliquer
Cancel = Annuler
Copper Area do not allow self-intersection! = 
No copper area! = Pas de zone de cuivre !
#Dialog report error
Datasheet = 
Verification = Vérification
Symbol = Symbole
Pad Number = Numéro de pastille
Pad Size = Taille de pastille
Remark = Remarque
Correct = Correct
Incorrect = Incorrect
Submit = Soumettre
Tip = Astuce
Please select one component = Veuillez sélectionner un composant
Location X = Position X
Location Y = Position Y
Your current browser version may not support some features. Please use the latest version of Chrome or Firefox, or try the desktop client. = La version actuelle de votre navigateur peut ne pas prendre en charge certaines fonctionnalités. Veuillez utiliser la dernière version de Chrome ou Firefox, ou essayez l'application.
EasyEDA Client = 
LCEDA Client = 
Chrome = Chrome
FireFox = FireFox
New Version = Nouvelle version
Switch Version = 
Member = Membre
Update Time = 
Editor = Éditeur
Current Version: = Version actuelle
Select a version to switch = 
3D Model = Modèle 3D
Board Side = 
Display = 
Copper = Cuivre
Create New Version = Créer une nouvelle version
Create new version success! = 
Version Management = 
Switch success! = 
Please close current version's documents first! = 
Creator = Créateur
Create Time = Date de création
Fail to connect to server! Please check your internet connection status and try again! = 
Spice Number = 
Create = Créer
3D Outline = 
Cannot create the slot hole via the board outline, please use the following methods: = 
Use the solid region and set its type as Board Cutout = 
Select a Track/Arc, right-click to use the "Convert to Board Cutout" = 
Select all the closed Tracks/Arcs, right-click to use the "Convert to Board Cutout" = 
The more information please refer at = 
Save "{0}" success! = 
Save "{0}" failed! = 
Invalid Size = Taille non valide
Processing = 
Invalid Size = Taille non valide
NetFlag GND = Drapeau Piste Gnd
NetFlag VCC = Drapeau Piste Vcc
NetFlag +5v = Drapeau Piste +5V
No Useful Data! = 
SVG Preview = 
Prefix contains not supported charater(s) ! = 
Name contains not supported charater(s) ! = 
Create Grid Path = 
Please Input Name = 
Building Copper Area = 
Processing = Traitement
Opening File = Ouverture du fichier
Update from Library = Actualiser depuis la bibliothèque
Update Footprint = Actualiser l'empreinte
Find footprint(s) have been updated, do you want to update? = 
3D File: = Fichier 3D:
Model List = Liste de modèle
Are you sure merge net {0} and net {1}? = 
Display Footprint = Afficher l'empreinte
Display Footprint Name While Placing Component = 
Annotate Prefix Automatically After Placing Component = 
Program Error, Please Contact Technical Support! = 
Search Engine = Moteur de recherche
Keyword to Filter = 
Normal Mode = Mode normal
Expand Mode = Mode étendu
3D Model Manager = Gestionnaire de modèle 3D
3D Model Preview = Prévisualisation de modèle 3D
3D Model = Modèle 3D
3DModel = Modèle 3D
Document = Document

[pcblayer]
3DModel = Modèle 3D
Document = Document
[/pcblayer]

Adjustment = 
View Larger Image = 
Previous = Précédent
Previous Image = Image précédente
Next Image = Suivant
Notice: For reference only, please refer to the real product = 
It's under designing, please wait. = 
The width of track/arc/circle can not less than 0.1mil! = 
clone success ! = 
Footprint Naming Reference = 
3D Model Manager = Gestionnaire de modèle 3D
Will jump to the Lichuang open source hardware platform (OSHWHub.com) to improve the information and share. Whether to continue? = 
Will jump to the EasyEDA open source hardware platform (OSHWLab.com) to improve the information and share. Whether to continue? = 
The project content page will open. After adding a description and setting the project to public, you can click the share button to get the share link. = 
This project is not public, can not view homepage! = Ce projet n'est pas public, impossible d'afficher la page d'accueil !

[grid]
None = Aucune
[/grid]

#lib verify and mounted
This component is verified = Ce composant est vérifié
This component is unmounted = Ce composant n'est pas vérifié

#find component
Find Next = 
Object not found = Objet non trouvé

##offset Elements
Offset X = 
Offset Y = 
Offset = 
Absolute Offset = 
Relative Offset = 
Absolute Offset... = 
Relative Offset... = 
Reference Point X = 
Reference Point Y = 

#内电层
Rebuild Plane = 
PlaneZone Properties = 
Change to a plane layer is not allowed during track routing. = 
#pcblib rect
Fill = Remplir
Fill Type = 
[PlaneZone]
Solid = 
[/PlaneZone]

Solid Region do not allow self-intersection! = 

The prefix or name or text too far away from the footprint, if you don't want it to show up please make it hidden. = 
The prefixes are not allowed to repeat! = 
Save failed! The origin of the canvas is not in the graphics! Whether to set the origin automatically? = 
The origin of the canvas has been set in the graphics now, you can save again. = 
Backup Project = Sauvegarder le projet
Open Project Directory = 

{0} items updated = 

The current file {0} has an updated version. Do you want to overwrite it? If you want to open the latest version, please close the current file and reopen it. = 
Yes, Overwrite It = Oui, l'écraser
No, Keep It = Non, le conserver

Download Client = Client de téléchargement

Search tutorial、open source projects etc. = 

Go to LCSC and search for = Aller chez LCSC et chercher pour
Go to LCSC = Aller chez LCSC

Hide Ratline Layer and Keep the Component Prefix When Paste Objects = 

ALL.layer = Tout les calques
Copper.layer = 
Non-Copper.layer = 
Other.layer = 

Please enter at least 2 characters! = 
View Datasheet = Voir la documentation
View Datasheet... = Voir la documentation...

The corresponding package or network could not be found in the currently open PCB document = 
delete fail = 

[crashRecovery]
Libraries = Bibliothèques
[/crashRecovery]
Canvas origin anomaly! = 

Component's Name = Nom du composant
Component's Prefix = Préfixe du composant
Component's Footprint = Empreinte du composant

[findlib]
Clear = Effacer
Apply Filters = Appliquer les filtres
Result = Résultat
Place = Placer
Prev = Précédent
Next = Suivant
Total {count} Count = 
About = À Propos de
Items = Objets
[/findlib]

Object = 
Layers and Objects = 
All = Tous

Add custom = 

Connections = 
Attempted: = 
Completed: = 
Failed: = 
Total Vias: = 

Please confirm moving option = 
Only this pad = 
For this component = 
View Owner = 
View Detail = Voir détail


# 批量放置过孔
Place Vias = 
Placing Vias = 
Removing Vias = 
Batch Vias for Copper = 
Add/Remove Vias = 
Diameter = Diamètre
Drill Diameter = 
Column Spacing = 
Row Spacing = 
Multiple vias have been placed, do you want to rebuild the copper area? = 
Remove vias finish, do you want to rebuild the copper area? = 
The width of track/arc/circle can not less than 0.051mm/2mil/0.002inch! = 
Save fail! Please try again! = 
Please select a copper outline = 
Can't find copper area at other layers, please add the copper area with the same net at other layer first. = 

Add favorite success! = 
Remove favorite success! = 
Remove favorite failed! = 
Whether if remove favorite? = 
Split by ';' for multi tags = 

This size is the determined size! = 
The associated pad has been locked = 
Split by space or , for multi tags = 

Rotation X = 
Rotation Y = 
Rotation Z = 

Some fields are filled invalid data = 
start time should be earlier than stop time = 
Number of points should be less than 100 in octave variation = 
Start frequency should be less than stop frequency. The suffix meg stands for Mega,m stands for milli = 
Get historical records fail! = 
This 3D model didn't create the outlines successfully, please import it again or contact with us. = 
There is No Tag! = Il n'y a pas de tag !
Assign successful! = 
Found footprint's pad number doesn't match the schematic component's pin number, please correct the pad number and try again! = 
Update Attribute = 
Please fill in at least 5 words. = 
Mouse hovering over the track to highlight the entire network = 
Net Highlighting While Cursor Hover the Track = 
When circle set as "Yes", the Pin length must more than 6 = 
Hi, I found a problem of your library, this library seems incorrect.\ntitle:{title}\nType:{type}\nlink:{link}\n{content}\nThank you! = 

Logout fail! Please try again! = 
Logout success! We look forward you to use LCEDA again! = 
Logout success! We look forward you to use EasyEDA again! = 
Click to Preview 3D = 
[logoutDialog]
Logout = Se déconnecter
[/logoutDialog]

[findlibTag]
All = Tous
[/findlibTag]

Export Pick and Place File = 
Mirror the bottom component's X coordinate (JLCPCB doesn't need) = 
Work Space = 
Include panelized components' coordinates = 
Personal Workspace = 
Work Space - {name} = 
Work Space - Personal = 
Cloning = 

Project Owner = 
Clone Project = 
Homepage = Page d'accueil
Apply for Education Edition = 
Load Organization failed = 
Joined = 
Favorite = 
This operation will unfavorite this project, do you want to continue? = 
View Homepage = Voir la page d'accueil
Private Project = 
3-7 days = 3-7 jours
Close Tab = Fermer l'onglet
Close Other Tabs = Fermer les autres onglets
Close All Tabs = Fermer tous les onglets
Open in New Window = Ouvrir dans une nouvelle fenêtre
Cursor Snap to Component's Origin or Pad Center While Dragging Component = 
Undefined = Non défini
Input = Entrée
Model Unit = 
File Unit = 
This part contains subparts, please make sure you have checked other subparts before reporting error, do you want to continue? = 

[saveAs]
Power = Puissance
[/saveAs]

Assign LCSC Part# = 
Unexpected error while converting. Perhaps unsupported file type or program bug. = 
Found duplicated component IDs, please click "OK" to re-assign component ID automatically, and then save the document and try again. = 

#electromagneticSimulation
Electromagnetic Simulation... = 
You will upload Gerebr to SuperEM for electromagnetic simulation (only upload Gerber, not including account data), do you want to continue? = 
SuperEM is a 3-D full-wave electromagnetic simulation and design platform for high-speed PCB circuits and antennas, which is developed by Faraday Dynamics, Ltd. = 
Visit the SuperEM = 
SuperEM User Guide = 
Upload Gerber to SuperEM successfully, please click "OK" buttun to continue = 

Format = Format
View = Vues
Design = Conception
Simulation = Simulation
Advanced = Avancé
Fabrication = Fabrication
Check DRC = 
Simulation Setting = 
BOM = Nomenclature
PCB Fabrication File(Gerber) = 
Pick and Place File = 
Parts Order = 
PCB Order = 
SIM = 
STD = 
WaveForm = Forme d'onde

Place Module = 
Please enter identification letters: = 
Only support English letters, up to 5. = Ne prend en charge que les lettres anglaises, jusqu'à 5.

Exist doesn't annotate prefix component(s) in the module, please edit and annotate the unique prefix(s) for component(s) first. = 
Opening = Ouverture

Also update track's net (Only applies to circumstance under which prefix/netlabel changes and no component/wire is added or removed) = 

# 客户端返回的错误提示
Cannot open online documents on Project Offline mode. = Impossible d'ouvrir des documents en ligne en mode Projet hors ligne.

Please select a project = Veuillez choisir un projet
Opened Projects = Projets ouverts
Open Project = Ouvrir un projet
Close Project = Fermer le projet
Open All Projects = Ouvrir tous les projets
Close All Projects = Fermer tous les projets

Doesn't support JLCPCB SMT Service = 
for JLCPCB SMT Service = 

Reset failed! There are duplicate component prefixes in the current schematic: = 
Reset failed! There are duplicate component prefixes in the current PCB: = 
Please modify the component prefixes first to ensure that the component prefix is unique. = 

LCEDA(Standard) - A Simple and Powerful Electronic Circuit Design Tool = LCEDA (Standard) - Un outil de conception de circuits électroniques simple et puissant
EasyEDA(Standard) - A Simple and Powerful Electronic Circuit Design Tool = EasyEDA (Standard) - Un outil de conception de circuits électroniques simple et puissant

#Dialog for Package Custom Data
Please input the data title = Veuillez saisir le titre des données
Data title duplicated = 
Cannot be more than {0} characters! = Ne peut pas contenir plus de {0} caractères !
Only latin alphabets, digits, underscore(_) and hyphen(-) are allowed. = 
Invalid value of item {0} = 
Update DFM = 
Custom DFM Data = 
Saved custom data successfully! = Données personnalisées enregistrées avec succès !
Save custom data failed! = 
Will replace the graphics and custom data of current document, after imported please adjust the 3D model. Continue or not? = 
Open footprint "Custom Data" dialog = 

#创建引脚外形
Create Lead Shape = 
Base on Pad Center = 
Base on Canvas Origin = 
Lead shape = 
Footprint Type = Type d'empreinte
From pad shape = 
Lead length = 
Lead width = 
Lead diameter = 
Scaling ratio = Rapport de mise à l'échelle
Leads creating direction = 
Auto = Auto
Horizontal = Horizontal
Vertical = Vertical
Canvas origin to lead edge = 
Canvas origin to body edge = 
Lead soldering length = 
Lead soldering part diameter = 
Component shape object doesn't overlap lead shape object, please check carefully. = 
The solder mask expansion of pads ({0},{1}) has a small clearance(less then 0.08mm), it will cause the soldering too short, please modify. = 
The paste mask expansion or custom paste mask layer objects of pads ({0},{1}) has a small clearance(less then 0.15mm), it will cause the stencil to create fail, please modify. = 
System footprint must exist pad number 1 or A1, please modify the pad number. = 
System footprint doesn't allow two or more pad numbers are 1 or A1, please modify the pad number. = 
Document layer has circle object, but jlcPara's polarity is 0, please check the Custom Data. = 
There are exist repeat pad numbers: {padNumber}, please check, if it is correct please ignore this. = 
Can't find the circle at the component marking layer, or this circle doesn't at the same quadrant with the 1st pad, please check whether it is correct. = 

ROUND = ROND
RECTANGLE = RECTANGLE
OCTAGONAL = OCTOGONAL
Upper left = En haut à gauche
Lower left = En bas à gauche
Center of Pads = 
First Pin = Première broche
Package Name = Nom du boîtier
Pins Number = 
Rows Of Pin = 
Columns Of Pin = 
Polarity = Polarité
Pad Shape = 
Body Diameter = Diamètre du corps
Lead Span = 
Lead Vertical Span = 
Body Length = Largeur du corps
Body Height = Hauteur du corps
Pin Diameter = Diamètre de la broche
Pin Length = Longueur de la broche
Pin Height = Heuteur de la broche
Pin Solid Width = 
Pin Solid Height = 
Pin Spacing = Espacement entre les broches
Pin Horizontal Spacing = 
Pin Vertical Spacing = 
ThermalPad = 
Pad Expansion = 
Custom PasteMask = 
Fabrication Tolerance = 
Plcarment Tolerance = 
FirstPin Position = 
Package Origin = 
Expansion Size = 
Corner = Coin
Angle = Angle
Fillet = Filet
Chamfer = Chanfrein
Update Preview = Mettre à jour l'aperçu
Number of pins (left and right) = 
Number of pins (up and down) = 
Reference Use Cases = 
Package Type = Type de boîtier
Capacitance = Condensateur
Resistance = Résistance
Bidirectional Diode = 
Inductance = Inductance
Crystal Oscillator = Oscillateur à cristal
Diode = Diode
LED = DEL
Fuse = Fusible
Entity height = 
Lead Overhang = 
Lead Thickness = Épaisseur de plomb
Unknown mistake = 
Has ThermalVias = 
Polar Capacitance = 

Create Component Marking = 
Create component marking successfully! = 
No elements on component shape layer! = 
No elements on lead shape layer! = 
No pad of number 1 or A1, please modify the pad number. = 
Save failed! Component marking circle is at the axis. Do you want to recreate the component marking? = 
If autoroute fail, you can export the autoroute file(DSN) to third-party autorouter tool(Such as: Konekt Electra, Eremex TopoR etc.), and export the session file(SES) after finished autoroute, and then import to PCB. = 
Auto route failed! Found abnormal pad(s) data, please modify the pad width and height: = 
Select Properties = Sélectionnez les propriétés
Combine the same parts' prefixes in one row = 
Please check at least one item! = 
Pins = Broches

